AAAAACACGTG -> AAAACACGTGG
AAAAACAGAGA -> AAAACAGAGAT
AAAACAATCTA -> AAACAATCTAA
AAAACACGTGG -> AAACACGTGGT
AAAACAGAGAT -> AAACAGAGATC
AAAACTTTGAA -> AAACTTTGAAG
AAAAGTTAGGC -> AAAGTTAGGCA
AAAATTGCAGG -> AAATTGCAGGA
AAACAATCTAA -> AACAATCTAAC
AAACACGTGGT -> AACACGTGGTG
AAACAGAGATC -> AACAGAGATCT
AAACCAGAATG -> AACCAGAATGC
AAACCGCATTA -> AACCGCATTAG
AAACGAACCTT -> AACGAACCTTC
AAACGCAAACG -> AACGCAAACGA
AAACTAAGAAC -> AACTAAGAACG
AAACTCGGGAA -> AACTCGGGAAC
AAACTTTGAAG -> AACTTTGAAGA
AAAGAATGGGA -> AAGAATGGGAG
AAAGCAACTAA -> AAGCAACTAAA
AAAGCAATTGT -> AAGCAATTGTA
AAAGCCTTCCT -> AAGCCTTCCTA
AAAGGATCGCC -> AAGGATCGCCT
AAAGGGGAAAG -> AAGGGGAAAGC
AAAGGGTATTC -> AAGGGTATTCT
AAAGTTAGGCA -> AAGTTAGGCAA
AAATCACGAGA -> AATCACGAGAA
AAATGCTCTCG -> AATGCTCTCGG
AAATTAACGCA -> AATTAACGCAT
AAATTGATGAT -> AATTGATGATT
AAATTGCAGGA -> AATTGCAGGAT
AACAATCTAAC -> ACAATCTAACC
AACACGTGGTG -> ACACGTGGTGC
AACACTGACTT -> ACACTGACTTA
AACAGAGATCT -> ACAGAGATCTC
AACAGCTACGC -> ACAGCTACGCA
AACCACGGAGT -> ACCACGGAGTT
AACCAGAATGC -> ACCAGAATGCC
AACCATTAGTG -> ACCATTAGTGA
AACCCAGACTC -> ACCCAGACTCT
AACCCCAAAGG -> ACCCCAAAGGA
AACCCCAGACA -> ACCCCAGACAA
AACCCCTCCCC -> ACCCCTCCCCT
AACCGCATTAG -> ACCGCATTAGT
AACCTTCGTCC -> ACCTTCGTCCG
AACGAAAGCAA -> ACGAAAGCAAC
AACGAACCTTC -> ACGAACCTTCG
AACGACATTGG -> ACGACATTGGC
AACGCAAACGA -> ACGCAAACGAA
AACGCATGGTG -> ACGCATGGTGA
AACGCCTAAGA -> ACGCCTAAGAT
AACGGCCGAGG -> ACGGCCGAGGG
AACGGCTTTTA -> ACGGCTTTTAG
AACGGTAGCTG -> ACGGTAGCTGC
AACTAAACTCG -> ACTAAACTCGG
AACTAAGAACG -> ACTAAGAACGC
AACTATATCGG -> ACTATATCGGA
AACTCGGGAAC -> ACTCGGGAACC
AACTCTAGCCG -> ACTCTAGCCGT
AACTTATTGAA -> ACTTATTGAAT
AACTTATTGCC -> ACTTATTGCCC
AACTTTGAAGA -> ACTTTGAAGAA
AAGAACGCCTA -> AGAACGCCTAA
AAGAACGGTAG -> AGAACGGTAGC
AAGAATGGGAG -> AGAATGGGAGC
AAGAATGGTCA -> AGAATGGTCAG
AAGACAGCTGT -> AGACAGCTGTA
AAGACCGCAGG -> AGACCGCAGGA
AAGACCTACGT -> AGACCTACGTT
AAGATAATATG -> AGATAATATGT
AAGATCCGTCG -> AGATCCGTCGT
AAGATTCGTAG -> AGATTCGTAGA
AAGCAACTAAA -> AGCAACTAAAC
AAGCAATTGTA -> AGCAATTGTAC
AAGCCCCGTAA -> AGCCCCGTAAG
AAGCCCGTGGG -> AGCCCGTGGGA
AAGCCTTCCTA -> AGCCTTCCTAG
AAGGATCGCCT -> AGGATCGCCTT
AAGGCACCTAC -> AGGCACCTACA
AAGGCGTCGTA -> AGGCGTCGTAC
AAGGGGAAAGC -> AGGGGAAAGCC
AAGGGTATTCT -> AGGGTATTCTA
AAGGGTTAAAA -> AGGGTTAAAAT
AAGTACAAGAC -> AGTACAAGACC
AAGTACAGATC -> AGTACAGATCT
AAGTCTCGCCT -> AGTCTCGCCTG
AAGTGAAATGC -> AGTGAAATGCT
AAGTGACCCTA -> AGTGACCCTAC
AAGTGCACGTA -> AGTGCACGTAG
AAGTTAGGCAA -> AGTTAGGCAAT
AAGTTTCAGAT -> AGTTTCAGATG
AATAATCTAAG -> ATAATCTAAGG
AATACAAACCG -> ATACAAACCGC
AATACACTATT -> ATACACTATTA
AATACCGTGAC -> ATACCGTGACG
AATACGAGATA -> ATACGAGATAC
AATACGATGTA -> ATACGATGTAT
AATACGGCTGG -> ATACGGCTGGA
AATATGTGCTA -> ATATGTGCTAT
AATCACGAGAA -> ATCACGAGAAC
AATCAGGAAGT -> ATCAGGAAGTG
AATCGCGTATG -> ATCGCGTATGA
AATCGTGGGTG -> ATCGTGGGTGA
AATCTAACCCC -> ATCTAACCCCT
AATCTAAGGCG -> ATCTAAGGCGT
AATCTTAGCGA -> ATCTTAGCGAT
AATGACGACTC -> ATGACGACTCA
AATGACGTTCC -> ATGACGTTCCG
AATGCCATAAC -> ATGCCATAACC
AATGCTCTCGG -> ATGCTCTCGGC
AATGGGAGCCC -> ATGGGAGCCCC
AATGGTCAGAT -> ATGGTCAGATA
AATGTATGTAG -> ATGTATGTAGG
AATGTCTCCTT -> ATGTCTCCTTG
AATTAACGCAT -> ATTAACGCATG
AATTACGGAGT -> ATTACGGAGTC
AATTGATGATT -> ATTGATGATTC
AATTGCAGGAT -> ATTGCAGGATG
AATTGTACGGT -> ATTGTACGGTT
AATTTTACAGA -> ATTTTACAGAG
ACAAACCAGAA -> CAAACCAGAAT
ACAAACCGCAT -> CAAACCGCATT
ACAAGACCTAC -> CAAGACCTACG
ACAAGCCCCGT -> CAAGCCCCGTA
ACAATACGGCT -> CAATACGGCTG
ACAATCTAACC -> CAATCTAACCC
ACACCGAGAGC -> CACCGAGAGCT
ACACGTGGTGC -> CACGTGGTGCA
ACACGTTCGCC -> CACGTTCGCCG
ACACTATTAGA -> CACTATTAGAA
ACACTGACTTA -> CACTGACTTAC
ACAGAGATCTC -> CAGAGATCTCG
ACAGAGTGTAC -> CAGAGTGTACA
ACAGATCTTGT -> CAGATCTTGTG
ACAGCAAAAGT -> CAGCAAAAGTT
ACAGCATCGCA -> CAGCATCGCAG
ACAGCTACGCA -> CAGCTACGCAA
ACAGCTGTAGT -> CAGCTGTAGTT
ACAGGATCTTG -> CAGGATCTTGA
ACAGGATTGTT -> CAGGATTGTTC
ACAGGCTCTAC -> CAGGCTCTACC
ACAGTAGAGAC -> CAGTAGAGACC
ACAGTGTGAAG -> CAGTGTGAAGA
ACATATTATGG -> CATATTATGGT
ACATCTATCCG -> CATCTATCCGG
ACATTAAGTGA -> CATTAAGTGAA
ACATTGGCTGT -> CATTGGCTGTT
ACCACGGAGTT -> CCACGGAGTTG
ACCAGAATGCC -> CCAGAATGCCA
ACCAGACTTGT -> CCAGACTTGTA
ACCAGCCACCG -> CCAGCCACCGA
ACCATTAGTGA -> CCATTAGTGAG
ACCCAGACTCT -> CCCAGACTCTG
ACCCCAAAGGA -> CCCCAAAGGAT
ACCCCAGACAA -> CCCCAGACAAT
ACCCCTCCCCT -> CCCCTCCCCTG
ACCCTACCGAT -> CCCTACCGATG
ACCCTAGAGGT -> CCCTAGAGGTT
ACCCTGGAGCC -> CCCTGGAGCCC
ACCGAAATTGA -> CCGAAATTGAT
ACCGACTACAT -> CCGACTACATC
ACCGAGAGCTG -> CCGAGAGCTGC
ACCGAGTGTGA -> CCGAGTGTGAT
ACCGATGTACC -> CCGATGTACCT
ACCGCAGGATA -> CCGCAGGATAT
ACCGCATTAGT -> CCGCATTAGTG
ACCGGTTCGTC -> CCGGTTCGTCG
ACCGTGACGCG -> CCGTGACGCGC
ACCGTGGCTTC -> CCGTGGCTTCA
ACCTACAGCAA -> CCTACAGCAAA
ACCTACGTTTC -> CCTACGTTTCA
ACCTCAATTAC -> CCTCAATTACG
ACCTCTGTCCC -> CCTCTGTCCCT
ACCTGATCGCG -> CCTGATCGCGG
ACCTGCACAGT -> CCTGCACAGTA
ACCTTCGTCCG -> CCTTCGTCCGA
ACCTTTGAAAC -> CCTTTGAAACG
ACGAAAGCAAC -> CGAAAGCAACT
ACGAACACTGA -> CGAACACTGAC
ACGAACCTTCG -> CGAACCTTCGT
ACGAACTTATT -> CGAACTTATTG
ACGACATTGGC -> CGACATTGGCT
ACGACTCATCA -> CGACTCATCAA
ACGAGAACTAT -> CGAGAACTATA
ACGAGATACGT -> CGAGATACGTG
ACGAGTGAGGG -> CGAGTGAGGGG
ACGAGTGTGCA -> CGAGTGTGCAC
ACGATGTATAT -> CGATGTATATT
ACGCAAACGAA -> CGCAAACGAAC
ACGCAATGTCT -> CGCAATGTCTC
ACGCATGGTGA -> CGCATGGTGAG
ACGCCTAAGAT -> CGCCTAAGATT
ACGCGCTCATT -> CGCGCTCATTG
ACGCGTTCCTT -> CGCGTTCCTTG
ACGCTGGGGGC -> CGCTGGGGGCT
ACGGAATTTTA -> CGGAATTTTAC
ACGGAGTCTGT -> CGGAGTCTGTT
ACGGAGTTGGG -> CGGAGTTGGGT
ACGGCCGAGGG -> CGGCCGAGGGC
ACGGCTGGAGT -> CGGCTGGAGTG
ACGGCTTTTAG -> CGGCTTTTAGC
ACGGGTTCCCC -> CGGGTTCCCCG
ACGGTAGCTGC -> CGGTAGCTGCG
ACGGTTTGTCG -> CGGTTTGTCGC
ACGTAGCACGT -> CGTAGCACGTG
ACGTCGTTCCA -> CGTCGTTCCAT
ACGTGCCGACA -> CGTGCCGACAC
ACGTGCGACCA -> CGTGCGACCAG
ACGTGCGGGCC -> CGTGCGGGCCT
ACGTGGTGCAG -> CGTGGTGCAGG
ACGTGTTGCTG -> CGTGTTGCTGC
ACGTGTTGGAG -> CGTGTTGGAGG
ACGTTATGAGC -> CGTTATGAGCT
ACGTTCCGGGC -> CGTTCCGGGCT
ACGTTCGAAAG -> CGTTCGAAAGG
ACGTTCGCCGA -> CGTTCGCCGAA
ACGTTGATGAT -> CGTTGATGATA
ACGTTTCAGTT -> CGTTTCAGTTA
ACTAAACTCGG -> CTAAACTCGGG
ACTAAGAACGC -> CTAAGAACGCC
ACTACATCTAT -> CTACATCTATC
ACTAGATATCC -> CTAGATATCCG
ACTAGCAGAAG -> CTAGCAGAAGA
ACTAGTTCATC -> CTAGTTCATCT
ACTATATCGGA -> CTATATCGGAT
ACTATTAGAAG -> CTATTAGAAGC
ACTCATCAACG -> CTCATCAACGG
ACTCGGGAACC -> CTCGGGAACCC
ACTCTAGCCGT -> CTCTAGCCGTC
ACTCTGAGTTG -> CTCTGAGTTGT
ACTCTGTTCTC -> CTCTGTTCTCC
ACTGACTTACC -> CTGACTTACCT
ACTGATGTCGA -> CTGATGTCGAT
ACTGGGCGCCC -> CTGGGCGCCCG
ACTTAATACAA -> CTTAATACAAA
ACTTACCTGAT -> CTTACCTGATC
ACTTATTGAAT -> CTTATTGAATA
ACTTATTGCCC -> CTTATTGCCCT
ACTTCAAGTTT -> CTTCAAGTTTC
ACTTGACAGGC -> CTTGACAGGCT
ACTTGCCTGCA -> CTTGCCTGCAA
ACTTGTACTAG -> CTTGTACTAGA
ACTTTCATGAC -> CTTTCATGACA
ACTTTGAAGAA -> CTTTGAAGAAC
AGAACAGCTAC -> GAACAGCTACG
AGAACGCCTAA -> GAACGCCTAAG
AGAACGGTAGC -> GAACGGTAGCT
AGAACTATATC -> GAACTATATCG
AGAAGACAGCT -> GAAGACAGCTG
AGAAGACCGCA -> GAAGACCGCAG
AGAAGCCCGTG -> GAAGCCCGTGG
AGAATGCCATA -> GAATGCCATAA
AGAATGGGAGC -> GAATGGGAGCC
AGAATGGTCAG -> GAATGGTCAGA
AGACAATACGG -> GACAATACGGC
AGACAGCTGTA -> GACAGCTGTAG
AGACCGACTAC -> GACCGACTACA
AGACCGCAGGA -> GACCGCAGGAT
AGACCGTGGCT -> GACCGTGGCTT
AGACCTACGTT -> GACCTACGTTT
AGACCTCTGTC -> GACCTCTGTCC
AGACTCTGAGT -> GACTCTGAGTT
AGACTTGTACT -> GACTTGTACTA
AGAGACCGACT -> GAGACCGACTA
AGAGATCTCGA -> GAGATCTCGAA
AGAGCCGCGAC -> GAGCCGCGACA
AGAGCCGGGAT -> GAGCCGGGATG
AGAGCCGTTAG -> GAGCCGTTAGC
AGAGCTGCAGC -> GAGCTGCAGCC
AGAGGGTGTAT -> GAGGGTGTATA
AGAGGTTTCAT -> GAGGTTTCATA
AGAGTGTACAG -> GAGTGTACAGT
AGATAAAGCAA -> GATAAAGCAAT
AGATAATATGT -> GATAATATGTG
AGATACAGGAT -> GATACAGGATT
AGATACGTGCG -> GATACGTGCGA
AGATATCCGAC -> GATATCCGACA
AGATCCAATGT -> GATCCAATGTA
AGATCCGTCGT -> GATCCGTCGTT
AGATCTCGAAT -> GATCTCGAATC
AGATCTTGTGT -> GATCTTGTGTA
AGATGATCGAC -> GATGATCGACT
AGATGCGTGCG -> GATGCGTGCGT
AGATTCGTAGA -> GATTCGTAGAC
AGCAAAAGTTA -> GCAAAAGTTAG
AGCAACTAAAC -> GCAACTAAACT
AGCAATTGTAC -> GCAATTGTACG
AGCACGTGTTG -> GCACGTGTTGG
AGCAGAAGACC -> GCAGAAGACCG
AGCAGGTTGAT -> GCAGGTTGATG
AGCATCGCAGG -> GCATCGCAGGC
AGCATTTAGTG -> GCATTTAGTGC
AGCCAATACAC -> GCCAATACACT
AGCCACCGAGT -> GCCACCGAGTG
AGCCATAGGGG -> GCCATAGGGGA
AGCCCATGCGA -> GCCCATGCGAG
AGCCCCCAGCA -> GCCCCCAGCAG
AGCCCCGTAAG -> GCCCCGTAAGG
AGCCCCTTCAG -> GCCCCTTCAGT
AGCCCGTGGGA -> GCCCGTGGGAA
AGCCGACATAT -> GCCGACATATT
AGCCGCGACAA -> GCCGCGACAAA
AGCCGGGATGC -> GCCGGGATGCT
AGCCGTCGGAC -> GCCGTCGGACC
AGCCGTTAGCC -> GCCGTTAGCCA
AGCCTCGCACG -> GCCTCGCACGA
AGCCTTATGGC -> GCCTTATGGCA
AGCCTTCCTAG -> GCCTTCCTAGT
AGCGATATTTG -> GCGATATTTGT
AGCTACGCAAT -> GCTACGCAATG
AGCTACTGGGC -> GCTACTGGGCG
AGCTGCAGCCC -> GCTGCAGCCCC
AGCTGCGTGAC -> GCTGCGTGACT
AGCTGTAGTTC -> GCTGTAGTTCG
AGCTTACGTGC -> GCTTACGTGCG
AGGAAGTGCAC -> GGAAGTGCACG
AGGAGGCACGA -> GGAGGCACGAG
AGGATATGATT -> GGATATGATTT
AGGATCGCCTT -> GGATCGCCTTA
AGGATCTTGAA -> GGATCTTGAAG
AGGATGAATGA -> GGATGAATGAC
AGGATTGTTCC -> GGATTGTTCCA
AGGCAATCGTG -> GGCAATCGTGG
AGGCACCTACA -> GGCACCTACAG
AGGCACGAGTG -> GGCACGAGTGT
AGGCATCCGGC -> GGCATCCGGCT
AGGCGGGTCAC -> GGCGGGTCACG
AGGCGTCGTAC -> GGCGTCGTACA
AGGCTCTACCA -> GGCTCTACCAG
AGGGCCGATAG -> GGGCCGATAGA
AGGGGAAACTA -> GGGGAAACTAA
AGGGGAAAGCC -> GGGGAAAGCCT
AGGGGCAAAGG -> GGGGCAAAGGG
AGGGTATTCTA -> GGGTATTCTAC
AGGGTGAATAC -> GGGTGAATACG
AGGGTGTATAC -> GGGTGTATACT
AGGGTTAAAAT -> GGGTTAAAATT
AGGTCTAAGTG -> GGTCTAAGTGA
AGGTTGATGTG -> GGTTGATGTGA
AGGTTTCATAC -> GGTTTCATACG
AGTAAAGAATG -> GTAAAGAATGG
AGTACAAGACC -> GTACAAGACCT
AGTACAGATCT -> GTACAGATCTT
AGTACTAGCAG -> GTACTAGCAGA
AGTAGAGACCG -> GTAGAGACCGA
AGTATGACGAG -> GTATGACGAGT
AGTCAGCATTT -> GTCAGCATTTA
AGTCTCGCCTG -> GTCTCGCCTGT
AGTCTGTTGAG -> GTCTGTTGAGA
AGTGAAATGCT -> GTGAAATGCTC
AGTGACCCTAC -> GTGACCCTACC
AGTGAGGGGCA -> GTGAGGGGCAA
AGTGAGTTTAG -> GTGAGTTTAGG
AGTGCAAAAAC -> GTGCAAAAACA
AGTGCACGTAG -> GTGCACGTAGC
AGTGCTTGTAG -> GTGCTTGTAGT
AGTGTACAGTG -> GTGTACAGTGT
AGTGTGAAGAT -> GTGTGAAGATA
AGTGTGATATC -> GTGTGATATCC
AGTGTGCACCT -> GTGTGCACCTC
AGTGTGTCAGA -> GTGTGTCAGAA
AGTGTGTGAGA -> GTGTGTGAGAG
AGTGTTCCCGG -> GTGTTCCCGGT
AGTTACCTTTG -> GTTACCTTTGA
AGTTAGCCTCG -> GTTAGCCTCGC
AGTTAGGCAAT -> GTTAGGCAATC
AGTTAGTTGGT -> GTTAGTTGGTA
AGTTATTATGC -> GTTATTATGCT
AGTTCATCTAT -> GTTCATCTATC
AGTTCGAACTT -> GTTCGAACTTA
AGTTCGACTCT -> GTTCGACTCTG
AGTTCGAGATG -> GTTCGAGATGC
AGTTGATTTTT -> GTTGATTTTTA
AGTTGGGTAAT -> GTTGGGTAATA
AGTTGGTATTA -> GTTGGTATTAC
AGTTGTCGCGG -> GTTGTCGCGGT
AGTTTAGGTCG -> GTTTAGGTCGT
AGTTTCAGATG -> GTTTCAGATGA
ATAAAGCAATT -> TAAAGCAATTG
ATAAATTAACG -> TAAATTAACGC
ATAACCCCAAA -> TAACCCCAAAG
ATAAGAATGGT -> TAAGAATGGTC
ATAATATGTGC -> TAATATGTGCT
ATAATCTAAGG -> TAATCTAAGGC
ATAATGACGTT -> TAATGACGTTC
ATACAAACCGC -> TACAAACCGCA
ATACACTATTA -> TACACTATTAG
ATACAGGATTG -> TACAGGATTGT
ATACCGTGACG -> TACCGTGACGC
ATACGAGATAC -> TACGAGATACG
ATACGATGTAT -> TACGATGTATA
ATACGGCTGGA -> TACGGCTGGAG
ATACGTCGTTC -> TACGTCGTTCC
ATACGTGCGAC -> TACGTGCGACC
ATACGTTATGA -> TACGTTATGAG
ATACTTTCATG -> TACTTTCATGA
ATAGAGCCGGG -> TAGAGCCGGGA
ATAGGGGAAAC -> TAGGGGAAACT
ATATCCGACAT -> TATCCGACATT
ATATCCGGACG -> TATCCGGACGC
ATATCGGATGA -> TATCGGATGAG
ATATGATTTAA -> TATGATTTAAG
ATATGTGCTAT -> TATGTGCTATG
ATATTATGGTA -> TATTATGGTAC
ATATTCACGAA -> TATTCACGAAC
ATATTCGGTCT -> TATTCGGTCTA
ATATTTGTAGT -> TATTTGTAGTT
ATCAACGGCCG -> TCAACGGCCGA
ATCACGAGAAC -> TCACGAGAACT
ATCAGACCGTG -> TCAGACCGTGG
ATCAGGAAGTG -> TCAGGAAGTGC
ATCCAATGTAT -> TCCAATGTATG
ATCCGACATTA -> TCCGACATTAA
ATCCGGACGCG -> TCCGGACGCGT
ATCCGGCTCCC -> TCCGGCTCCCA
ATCCGGGGGGC -> TCCGGGGGGCT
ATCCGTCGTTA -> TCCGTCGTTAA
ATCCTGCAGTT -> TCCTGCAGTTA
ATCGACTTGAC -> TCGACTTGACA
ATCGCAGGCGG -> TCGCAGGCGGG
ATCGCCAACGA -> TCGCCAACGAC
ATCGCCTTAAC -> TCGCCTTAACC
ATCGCGGTAAT -> TCGCGGTAATC
ATCGCGTATGA -> TCGCGTATGAA
ATCGCTGGCTG -> TCGCTGGCTGA
ATCGGATGAGC -> TCGGATGAGCC
ATCGTGGGTGA -> TCGTGGGTGAC
ATCTAACCCCT -> TCTAACCCCTC
ATCTAAGGCGT -> TCTAAGGCGTC
ATCTATCAGAC -> TCTATCAGACC
ATCTATCCGGG -> TCTATCCGGGG
ATCTCGAATCT -> TCTCGAATCTT
ATCTGGCCAGA -> TCTGGCCAGAG
ATCTTAGCGAT -> TCTTAGCGATA
ATCTTGAAGGG -> TCTTGAAGGGT
ATCTTGTGTAT -> TCTTGTGTATA
ATGAAAACTTT -> TGAAAACTTTG
ATGAATGACGA -> TGAATGACGAC
ATGACAGCATC -> TGACAGCATCG
ATGACGACTCA -> TGACGACTCAT
ATGACGAGTGA -> TGACGAGTGAG
ATGACGTTCCG -> TGACGTTCCGG
ATGAGCCAATA -> TGAGCCAATAC
ATGAGCTACTG -> TGAGCTACTGG
ATGATAAATTA -> TGATAAATTAA
ATGATCGACTT -> TGATCGACTTG
ATGATTCGTTC -> TGATTCGTTCG
ATGATTTAAGA -> TGATTTAAGAT
ATGCACGTTCG -> TGCACGTTCGA
ATGCCATAACC -> TGCCATAACCC
ATGCGAGGGTG -> TGCGAGGGTGA
ATGCGTGCGTG -> TGCGTGCGTGA
ATGCTACGGGT -> TGCTACGGGTT
ATGCTCCGAAG -> TGCTCCGAAGT
ATGCTCTCGGC -> TGCTCTCGGCG
ATGGCACCCTA -> TGGCACCCTAG
ATGGGAGCCCC -> TGGGAGCCCCT
ATGGGCAGAAG -> TGGGCAGAAGA
ATGGTACGGAA -> TGGTACGGAAT
ATGGTCAGATA -> TGGTCAGATAC
ATGGTGAGTTG -> TGGTGAGTTGA
ATGTACCTGCA -> TGTACCTGCAC
ATGTAGGTCTA -> TGTAGGTCTAA
ATGTATATTCA -> TGTATATTCAC
ATGTATGTAGG -> TGTATGTAGGT
ATGTCCTTAAA -> TGTCCTTAAAA
ATGTCGATGGG -> TGTCGATGGGC
ATGTCTCCTTG -> TGTCTCCTTGA
ATGTGACTGAT -> TGTGACTGATG
ATGTGCTATGT -> TGTGCTATGTC
ATTAACGCATG -> TTAACGCATGG
ATTAAGTGAAA -> TTAAGTGAAAT
ATTACCGGTTC -> TTACCGGTTCG
ATTACGGAGTC -> TTACGGAGTCT
ATTAGAAGCCC -> TTAGAAGCCCG
ATTAGTGAGTT -> TTAGTGAGTTT
ATTAGTGTGTC -> TTAGTGTGTCA
ATTATGCTCCG -> TTATGCTCCGA
ATTATGGTACG -> TTATGGTACGG
ATTCAATACGA -> TTCAATACGAT
ATTCACGAACT -> TTCACGAACTT
ATTCCGCCCCG -> TTCCGCCCCGG
ATTCGGTCTAC -> TTCGGTCTACA
ATTCGTAGACC -> TTCGTAGACCT
ATTCGTTCGGC -> TTCGTTCGGCT
ATTCTACGTTG -> TTCTACGTTGA
ATTGAACTCTA -> TTGAACTCTAG
ATTGAATACCG -> TTGAATACCGT
ATTGATGATTC -> TTGATGATTCG
ATTGCAGGATG -> TTGCAGGATGA
ATTGCCCTTAC -> TTGCCCTTACA
ATTGGCTGTTT -> TTGGCTGTTTC
ATTGTACGGTT -> TTGTACGGTTT
ATTGTTCCAAC -> TTGTTCCAACG
ATTTAAGATCC -> TTTAAGATCCG
ATTTAGCCTTA -> TTTAGCCTTAT
ATTTAGTGCAA -> TTTAGTGCAAA
ATTTGTAGTTA -> TTTGTAGTTAC
ATTTTACAGAG -> TTTTACAGAGT
ATTTTTAATCA -> TTTTTAATCAG
CAAAAACAGAG -> AAAAACAGAGA
CAAAAGTTAGG -> AAAAGTTAGGC
CAAACCAGAAT -> AAACCAGAATG
CAAACCGCATT -> AAACCGCATTA
CAAACGAACCT -> AAACGAACCTT
CAAAGGATCGC -> AAAGGATCGCC
CAAAGGGGAAA -> AAAGGGGAAAG
CAACGAAAGCA -> AACGAAAGCAA
CAACGACATTG -> AACGACATTGG
CAACGGCCGAG -> AACGGCCGAGG
CAACGGCTTTT -> AACGGCTTTTA
CAACTAAACTC -> AACTAAACTCG
CAAGACCTACG -> AAGACCTACGT
CAAGCCCCGTA -> AAGCCCCGTAA
CAAGTCTCGCC -> AAGTCTCGCCT
CAAGTTTCAGA -> AAGTTTCAGAT
CAATACACTAT -> AATACACTATT
CAATACGATGT -> AATACGATGTA
CAATACGGCTG -> AATACGGCTGG
CAATCGTGGGT -> AATCGTGGGTG
CAATCTAACCC -> AATCTAACCCC
CAATGTATGTA -> AATGTATGTAG
CAATGTCTCCT -> AATGTCTCCTT
CAATTACGGAG -> AATTACGGAGT
CAATTGTACGG -> AATTGTACGGT
CACAGTAGAGA -> ACAGTAGAGAC
CACCCTAGAGG -> ACCCTAGAGGT
CACCGAGAGCT -> ACCGAGAGCTG
CACCGAGTGTG -> ACCGAGTGTGA
CACCTACAGCA -> ACCTACAGCAA
CACCTCAATTA -> ACCTCAATTAC
CACGAACACTG -> ACGAACACTGA
CACGAACTTAT -> ACGAACTTATT
CACGAGAACTA -> ACGAGAACTAT
CACGAGTGTGC -> ACGAGTGTGCA
CACGCTGGGGG -> ACGCTGGGGGC
CACGGAGTTGG -> ACGGAGTTGGG
CACGTAGCACG -> ACGTAGCACGT
CACGTGCCGAC -> ACGTGCCGACA
CACGTGGTGCA -> ACGTGGTGCAG
CACGTGTTGGA -> ACGTGTTGGAG
CACGTTCGAAA -> ACGTTCGAAAG
CACGTTCGCCG -> ACGTTCGCCGA
CACTATTAGAA -> ACTATTAGAAG
CACTGACTTAC -> ACTGACTTACC
CAGAACAGCTA -> AGAACAGCTAC
CAGAAGACAGC -> AGAAGACAGCT
CAGAAGACCGC -> AGAAGACCGCA
CAGAATGCCAT -> AGAATGCCATA
CAGACAATACG -> AGACAATACGG
CAGACCGTGGC -> AGACCGTGGCT
CAGACTCTGAG -> AGACTCTGAGT
CAGACTTGTAC -> AGACTTGTACT
CAGAGATCTCG -> AGAGATCTCGA
CAGAGCCGCGA -> AGAGCCGCGAC
CAGAGTGTACA -> AGAGTGTACAG
CAGATACAGGA -> AGATACAGGAT
CAGATCTTGTG -> AGATCTTGTGT
CAGATGATCGA -> AGATGATCGAC
CAGCAAAAGTT -> AGCAAAAGTTA
CAGCAGGTTGA -> AGCAGGTTGAT
CAGCATCGCAG -> AGCATCGCAGG
CAGCATTTAGT -> AGCATTTAGTG
CAGCCACCGAG -> AGCCACCGAGT
CAGCCCCCAGC -> AGCCCCCAGCA
CAGCTACGCAA -> AGCTACGCAAT
CAGCTGTAGTT -> AGCTGTAGTTC
CAGGAAGTGCA -> AGGAAGTGCAC
CAGGATATGAT -> AGGATATGATT
CAGGATCTTGA -> AGGATCTTGAA
CAGGATGAATG -> AGGATGAATGA
CAGGATTGTTC -> AGGATTGTTCC
CAGGCATCCGG -> AGGCATCCGGC
CAGGCGGGTCA -> AGGCGGGTCAC
CAGGCTCTACC -> AGGCTCTACCA
CAGGTTGATGT -> AGGTTGATGTG
CAGTAGAGACC -> AGTAGAGACCG
CAGTCAGCATT -> AGTCAGCATTT
CAGTGCTTGTA -> AGTGCTTGTAG
CAGTGTGAAGA -> AGTGTGAAGAT
CAGTTAGTTGG -> AGTTAGTTGGT
CAGTTATTATG -> AGTTATTATGC
CAGTTCGAGAT -> AGTTCGAGATG
CATAACCCCAA -> ATAACCCCAAA
CATAATGACGT -> ATAATGACGTT
CATACGTCGTT -> ATACGTCGTTC
CATAGGGGAAA -> ATAGGGGAAAC
CATATTATGGT -> ATATTATGGTA
CATCAACGGCC -> ATCAACGGCCG
CATCCGGCTCC -> ATCCGGCTCCC
CATCGCAGGCG -> ATCGCAGGCGG
CATCGCCAACG -> ATCGCCAACGA
CATCGCTGGCT -> ATCGCTGGCTG
CATCTATCAGA -> ATCTATCAGAC
CATCTATCCGG -> ATCTATCCGGG
CATCTGGCCAG -> ATCTGGCCAGA
CATGACAGCAT -> ATGACAGCATC
CATGCGAGGGT -> ATGCGAGGGTG
CATGGTGAGTT -> ATGGTGAGTTG
CATTAAGTGAA -> ATTAAGTGAAA
CATTAGTGAGT -> ATTAGTGAGTT
CATTAGTGTGT -> ATTAGTGTGTC
CATTGAACTCT -> ATTGAACTCTA
CATTGGCTGTT -> ATTGGCTGTTT
CATTTAGTGCA -> ATTTAGTGCAA
CCAAAGGATCG -> CAAAGGATCGC
CCAACGACATT -> CAACGACATTG
CCAACGGCTTT -> CAACGGCTTTT
CCAATACACTA -> CAATACACTAT
CCAATGTATGT -> CAATGTATGTA
CCACCGAGTGT -> CACCGAGTGTG
CCACGGAGTTG -> CACGGAGTTGG
CCAGAATGCCA -> CAGAATGCCAT
CCAGACAATAC -> CAGACAATACG
CCAGACTCTGA -> CAGACTCTGAG
CCAGACTTGTA -> CAGACTTGTAC
CCAGAGCCGCG -> CAGAGCCGCGA
CCAGCAGGTTG -> CAGCAGGTTGA
CCAGCCACCGA -> CAGCCACCGAG
CCAGTTCGAGA -> CAGTTCGAGAT
CCATAACCCCA -> CATAACCCCAA
CCATAATGACG -> CATAATGACGT
CCATAGGGGAA -> CATAGGGGAAA
CCATCGCCAAC -> CATCGCCAACG
CCATCGCTGGC -> CATCGCTGGCT
CCATGCGAGGG -> CATGCGAGGGT
CCATTAGTGAG -> CATTAGTGAGT
CCCAAAGGATC -> CCAAAGGATCG
CCCAGACAATA -> CCAGACAATAC
CCCAGACTCTG -> CCAGACTCTGA
CCCAGCAGGTT -> CCAGCAGGTTG
CCCAGTTCGAG -> CCAGTTCGAGA
CCCATCGCCAA -> CCATCGCCAAC
CCCATGCGAGG -> CCATGCGAGGG
CCCCAAAGGAT -> CCCAAAGGATC
CCCCAGACAAT -> CCCAGACAATA
CCCCAGCAGGT -> CCCAGCAGGTT
CCCCCAGCAGG -> CCCCAGCAGGT
CCCCGAGTTAG -> CCCGAGTTAGC
CCCCGGATCCT -> CCCGGATCCTG
CCCCGTAAGGC -> CCCGTAAGGCA
CCCCTCCCCTG -> CCCTCCCCTGG
CCCCTGGCCCA -> CCCTGGCCCAT
CCCCTTCAGTG -> CCCTTCAGTGC
CCCGAGTTAGC -> CCGAGTTAGCC
CCCGGACTTAA -> CCGGACTTAAT
CCCGGATCCTG -> CCGGATCCTGC
CCCGGGAAAAA -> CCGGGAAAAAC
CCCGGTGCTTA -> CCGGTGCTTAA
CCCGTAAGGCA -> CCGTAAGGCAC
CCCGTGGGAAG -> CCGTGGGAAGT
CCCTACCGATG -> CCTACCGATGT
CCCTACTAGTT -> CCTACTAGTTC
CCCTAGAGGTT -> CCTAGAGGTTT
CCCTCCCCTGG -> CCTCCCCTGGC
CCCTGCAACGA -> CCTGCAACGAA
CCCTGGAGCCC -> CCTGGAGCCCA
CCCTGGCCCAT -> CCTGGCCCATC
CCCTTACAAGC -> CCTTACAAGCC
CCCTTCAGTGC -> CCTTCAGTGCT
CCGAAATTGAT -> CGAAATTGATG
CCGAACCACGG -> CGAACCACGGA
CCGAAGTACAA -> CGAAGTACAAG
CCGACACGTTC -> CGACACGTTCG
CCGACATATTA -> CGACATATTAT
CCGACATTAAG -> CGACATTAAGT
CCGACTACATC -> CGACTACATCT
CCGACTTCAAG -> CGACTTCAAGT
CCGAGAGCTGC -> CGAGAGCTGCA
CCGAGGGCCGA -> CGAGGGCCGAT
CCGAGTGTGAT -> CGAGTGTGATA
CCGAGTTAGCC -> CGAGTTAGCCT
CCGATAGAGCC -> CGATAGAGCCG
CCGATGTACCT -> CGATGTACCTG
CCGCAGGATAT -> CGCAGGATATG
CCGCATTAGTG -> CGCATTAGTGT
CCGCCCCGGAT -> CGCCCCGGATC
CCGCGACAAAC -> CGCGACAAACC
CCGGACGCGTT -> CGGACGCGTTC
CCGGACTTAAT -> CGGACTTAATA
CCGGATCCTGC -> CGGATCCTGCA
CCGGCACGTGC -> CGGCACGTGCC
CCGGCTCCCAG -> CGGCTCCCAGT
CCGGGAAAAAC -> CGGGAAAAACA
CCGGGATGCTA -> CGGGATGCTAC
CCGGGCTCGTC -> CGGGCTCGTCT
CCGGGGGGCTT -> CGGGGGGCTTG
CCGGTGCTTAA -> CGGTGCTTAAA
CCGGTTCGTCG -> CGGTTCGTCGT
CCGTAAGGCAC -> CGTAAGGCACC
CCGTCGGACCG -> CGTCGGACCGA
CCGTCGTTAAC -> CGTCGTTAACC
CCGTGACGCGC -> CGTGACGCGCT
CCGTGGCTTCA -> CGTGGCTTCAG
CCGTGGGAAGT -> CGTGGGAAGTA
CCGTTAGCCAT -> CGTTAGCCATA
CCTAAGATTCG -> CTAAGATTCGT
CCTACAGCAAA -> CTACAGCAAAA
CCTACCGATGT -> CTACCGATGTA
CCTACGTTTCA -> CTACGTTTCAG
CCTACTAGTTC -> CTACTAGTTCA
CCTAGAGGTTT -> CTAGAGGTTTC
CCTAGCCGACA -> CTAGCCGACAT
CCTAGTAAAGA -> CTAGTAAAGAA
CCTCAATTACG -> CTCAATTACGG
CCTCATCTGGC -> CTCATCTGGCC
CCTCCCCTGGC -> CTCCCCTGGCC
CCTCGCACGAA -> CTCGCACGAAC
CCTCTGTCCCT -> CTCTGTCCCTA
CCTGATCGCGG -> CTGATCGCGGT
CCTGCAACGAA -> CTGCAACGAAA
CCTGCAAGTCT -> CTGCAAGTCTC
CCTGCACAGTA -> CTGCACAGTAG
CCTGCAGTTAT -> CTGCAGTTATT
CCTGGAGCCCA -> CTGGAGCCCAT
CCTGGCCCATC -> CTGGCCCATCG
CCTGTAGATAA -> CTGTAGATAAA
CCTTAAAACAA -> CTTAAAACAAT
CCTTAACCATT -> CTTAACCATTA
CCTTACAAGCC -> CTTACAAGCCC
CCTTAGTATGA -> CTTAGTATGAC
CCTTATGGCAC -> CTTATGGCACC
CCTTCAGTGCT -> CTTCAGTGCTT
CCTTCCTAGTA -> CTTCCTAGTAA
CCTTCGTCCGA -> CTTCGTCCGAC
CCTTGACCCTG -> CTTGACCCTGG
CCTTGTTATAT -> CTTGTTATATT
CCTTTGAAACG -> CTTTGAAACGC
CGAAAGCAACT -> GAAAGCAACTA
CGAAAGGGTAT -> GAAAGGGTATT
CGAAATTGATG -> GAAATTGATGA
CGAACACTGAC -> GAACACTGACT
CGAACCACGGA -> GAACCACGGAG
CGAACCTTCGT -> GAACCTTCGTC
CGAACTTATTG -> GAACTTATTGC,GAACTTATTGA
CGAAGTACAAG -> GAAGTACAAGA
CGAATCTTAGC -> GAATCTTAGCG
CGACAAACCAG -> GACAAACCAGA
CGACACGTTCG -> GACACGTTCGC
CGACATATTAT -> GACATATTATG
CGACATTAAGT -> GACATTAAGTG
CGACATTGGCT -> GACATTGGCTG
CGACCAGACTT -> GACCAGACTTG
CGACTACATCT -> GACTACATCTA
CGACTCATCAA -> GACTCATCAAC
CGACTCTGTTC -> GACTCTGTTCT
CGACTTCAAGT -> GACTTCAAGTT
CGACTTGACAG -> GACTTGACAGG
CGAGAACTATA -> GAGAACTATAT
CGAGAGCTGCA -> GAGAGCTGCAG
CGAGATACGTG -> GAGATACGTGC
CGAGATGCGTG -> GAGATGCGTGC
CGAGGGCCGAT -> GAGGGCCGATA
CGAGGGTGAAT -> GAGGGTGAATA
CGAGTGAGGGG -> GAGTGAGGGGC
CGAGTGTGATA -> GAGTGTGATAT
CGAGTGTGCAC -> GAGTGTGCACC
CGAGTTAGCCT -> GAGTTAGCCTC
CGATAGAGCCG -> GATAGAGCCGG
CGATATTTGTA -> GATATTTGTAG
CGATGGGCAGA -> GATGGGCAGAA
CGATGTACCTG -> GATGTACCTGC
CGATGTATATT -> GATGTATATTC
CGCAAACGAAC -> GCAAACGAACC
CGCAATGTCTC -> GCAATGTCTCC
CGCACGAACAC -> GCACGAACACT
CGCAGGATATG -> GCAGGATATGA
CGCAGGCGGGT -> GCAGGCGGGTC
CGCATGGTGAG -> GCATGGTGAGT
CGCATTAGTGT -> GCATTAGTGTG
CGCCAACGACA -> GCCAACGACAT
CGCCCCGGATC -> GCCCCGGATCC
CGCCCGGGAAA -> GCCCGGGAAAA
CGCCGAACCAC -> GCCGAACCACG
CGCCTAAGATT -> GCCTAAGATTC
CGCCTGTAGAT -> GCCTGTAGATA
CGCCTTAACCA -> GCCTTAACCAT
CGCGACAAACC -> GCGACAAACCA
CGCGCTCATTG -> GCGCTCATTGA
CGCGGTAATCG -> GCGGTAATCGC
CGCGGTCCATC -> GCGGTCCATCG
CGCGTATGAAA -> GCGTATGAAAA
CGCGTTCCTTG -> GCGTTCCTTGT
CGCTATTCAAT -> GCTATTCAATA
CGCTATTCCGC -> GCTATTCCGCC
CGCTCATTGAA -> GCTCATTGAAC
CGCTGGCTGAG -> GCTGGCTGAGT
CGCTGGGGGCT -> GCTGGGGGCTT
CGGAATTTTAC -> GGAATTTTACA
CGGACCGAAAT -> GGACCGAAATT
CGGACGCGTTC -> GGACGCGTTCC
CGGACTTAATA -> GGACTTAATAC
CGGAGTCTGTT -> GGAGTCTGTTG
CGGAGTTGGGT -> GGAGTTGGGTA
CGGATCCTGCA -> GGATCCTGCAG
CGGATGAGCCA -> GGATGAGCCAA
CGGCACGTGCC -> GGCACGTGCCG
CGGCCGAGGGC -> GGCCGAGGGCC
CGGCGGTGGGC -> GGCGGTGGGCT
CGGCTCCCAGT -> GGCTCCCAGTT
CGGCTCCTCAT -> GGCTCCTCATC
CGGCTGGAGTG -> GGCTGGAGTGT
CGGCTTTTAGC -> GGCTTTTAGCT
CGGGAAAAACA -> GGGAAAAACAC
CGGGAACCCCA -> GGGAACCCCAG
CGGGATGCTAC -> GGGATGCTACG
CGGGCCTAGCC -> GGGCCTAGCCG
CGGGCTCGTCT -> GGGCTCGTCTT
CGGGGGGCTTG -> GGGGGGCTTGA
CGGGGTCTTTA -> GGGGTCTTTAG
CGGGTCACGCT -> GGGTCACGCTG
CGGGTTCCCCG -> GGGTTCCCCGA
CGGTAATCGCG -> GGTAATCGCGT
CGGTAGCTGCG -> GGTAGCTGCGT
CGGTCCATCGC -> GGTCCATCGCT
CGGTCTACAGG -> GGTCTACAGGA
CGGTGCTTAAA -> GGTGCTTAAAT
CGGTGGGCTTC -> GGTGGGCTTCT
CGGTTCGTCGT -> GGTTCGTCGTG
CGGTTTGTCGC -> GGTTTGTCGCT
CGTAAGGCACC -> GTAAGGCACCT
CGTACACCGAG -> GTACACCGAGA
CGTAGACCTCT -> GTAGACCTCTG
CGTAGCACGTG -> GTAGCACGTGT
CGTATGAAAAC -> GTATGAAAACT
CGTCCGACTTC -> GTCCGACTTCA
CGTCGGACCGA -> GTCGGACCGAA
CGTCGTACACC -> GTCGTACACCG
CGTCGTGGTCC -> GTCGTGGTCCG
CGTCGTTAACC -> GTCGTTAACCC
CGTCGTTCCAT -> GTCGTTCCATA
CGTCTTTGCCC -> GTCTTTGCCCG
CGTGACGCGCT -> GTGACGCGCTC
CGTGACTTGCC -> GTGACTTGCCT
CGTGATGCACG -> GTGATGCACGT
CGTGCCGACAC -> GTGCCGACACG
CGTGCGACCAG -> GTGCGACCAGA
CGTGCGGGCCT -> GTGCGGGCCTA
CGTGCGTGATG -> GTGCGTGATGC
CGTGGCTTCAG -> GTGGCTTCAGT
CGTGGGAAGTA -> GTGGGAAGTAC
CGTGGGTGACG -> GTGGGTGACGT
CGTGGTCCGGC -> GTGGTCCGGCA
CGTGGTGCAGG -> GTGGTGCAGGC
CGTGTTGCTGC -> GTGTTGCTGCC
CGTGTTGGAGG -> GTGTTGGAGGA
CGTTAACCCAG -> GTTAACCCAGA
CGTTAGCCATA -> GTTAGCCATAG
CGTTATGAGCT -> GTTATGAGCTA
CGTTCCATAAT -> GTTCCATAATG
CGTTCCGGGCT -> GTTCCGGGCTC
CGTTCCTTGTT -> GTTCCTTGTTA
CGTTCGAAAGG -> GTTCGAAAGGG
CGTTCGCCGAA -> GTTCGCCGAAC
CGTTCGGCTCC -> GTTCGGCTCCT
CGTTGATGATA -> GTTGATGATAA
CGTTTCAGTTA -> GTTTCAGTTAG
CTAAACTCGGG -> TAAACTCGGGA
CTAACCCCTCC -> TAACCCCTCCC
CTAAGAACGCC -> TAAGAACGCCT
CTAAGATTCGT -> TAAGATTCGTA
CTAAGGCGTCG -> TAAGGCGTCGT
CTAAGTGACCC -> TAAGTGACCCT
CTACAGCAAAA -> TACAGCAAAAG
CTACAGGATCT -> TACAGGATCTT
CTACATCTATC -> TACATCTATCC
CTACCAGCCAC -> TACCAGCCACC
CTACCGATGTA -> TACCGATGTAC
CTACGCAATGT -> TACGCAATGTC
CTACGGGTTCC -> TACGGGTTCCC
CTACGTTGATG -> TACGTTGATGA
CTACGTTTCAG -> TACGTTTCAGT
CTACTAGTTCA -> TACTAGTTCAT
CTACTGGGCGC -> TACTGGGCGCC
CTAGAGGTTTC -> TAGAGGTTTCA
CTAGATATCCG -> TAGATATCCGA
CTAGCAGAAGA -> TAGCAGAAGAC
CTAGCCGACAT -> TAGCCGACATA
CTAGCCGTCGG -> TAGCCGTCGGA
CTAGTAAAGAA -> TAGTAAAGAAT
CTAGTTCATCT -> TAGTTCATCTA
CTATATCGGAT -> TATATCGGATG
CTATCAGACCG -> TATCAGACCGT
CTATCCGGGGG -> TATCCGGGGGG
CTATGTCCTTA -> TATGTCCTTAA
CTATTAGAAGC -> TATTAGAAGCC
CTATTCAATAC -> TATTCAATACG
CTATTCCGCCC -> TATTCCGCCCC
CTCAATTACGG -> TCAATTACGGA
CTCATCAACGG -> TCATCAACGGC
CTCATCTGGCC -> TCATCTGGCCA
CTCATTGAACT -> TCATTGAACTC
CTCCCAGTTCG -> TCCCAGTTCGA
CTCCCCTGGCC -> TCCCCTGGCCC
CTCCCTGCAAC -> TCCCTGCAACG
CTCCGAAGTAC -> TCCGAAGTACA
CTCCTCATCTG -> TCCTCATCTGG
CTCCTTGACCC -> TCCTTGACCCT
CTCGAATCTTA -> TCGAATCTTAG
CTCGCACGAAC -> TCGCACGAACA
CTCGCCTGTAG -> TCGCCTGTAGA
CTCGGCGGTGG -> TCGGCGGTGGG
CTCGGGAACCC -> TCGGGAACCCC
CTCGTCTTTGC -> TCGTCTTTGCC
CTCTACCAGCC -> TCTACCAGCCA
CTCTAGCCGTC -> TCTAGCCGTCG
CTCTCGGCGGT -> TCTCGGCGGTG
CTCTGAGTTGT -> TCTGAGTTGTC
CTCTGTCCCTA -> TCTGTCCCTAC
CTCTGTTCTCC -> TCTGTTCTCCC
CTGACTTACCT -> TGACTTACCTG
CTGAGTGTGTG -> TGAGTGTGTGA
CTGAGTTGTCG -> TGAGTTGTCGC
CTGATCGCGGT -> TGATCGCGGTA
CTGATGTCGAT -> TGATGTCGATG
CTGCAACGAAA -> TGCAACGAAAG
CTGCAAGTCTC -> TGCAAGTCTCG
CTGCACAGTAG -> TGCACAGTAGA
CTGCAGCCCCC -> TGCAGCCCCCA
CTGCAGTTATT -> TGCAGTTATTA
CTGCCTTAGTA -> TGCCTTAGTAT
CTGCGTGACTT -> TGCGTGACTTG
CTGGAGCCCAT -> TGGAGCCCATG
CTGGAGTGTTC -> TGGAGTGTTCC
CTGGATAAGAA -> TGGATAAGAAT
CTGGCCAGAGC -> TGGCCAGAGCC
CTGGCCCATCG -> TGGCCCATCGC
CTGGCGGGGTC -> TGGCGGGGTCT
CTGGCTGAGTG -> TGGCTGAGTGT
CTGGGCGCCCG -> TGGGCGCCCGG
CTGGGGGCTTC -> TGGGGGCTTCG
CTGTAGATAAA -> TGTAGATAAAG
CTGTAGTTCGA -> TGTAGTTCGAA
CTGTCCCTACT -> TGTCCCTACTA
CTGTTCTCCCT -> TGTTCTCCCTG
CTGTTGAGATC -> TGTTGAGATCC
CTGTTTCTGGC -> TGTTTCTGGCG
CTTAAAACAAT -> TTAAAACAATC
CTTAAATCACG -> TTAAATCACGA
CTTAACCATTA -> TTAACCATTAG
CTTAATACAAA -> TTAATACAAAC
CTTACAAGCCC -> TTACAAGCCCC
CTTACCTGATC -> TTACCTGATCG
CTTACGTGCGG -> TTACGTGCGGG
CTTAGCGATAT -> TTAGCGATATT
CTTAGTATGAC -> TTAGTATGACG
CTTATGGCACC -> TTATGGCACCC
CTTATTGAATA -> TTATTGAATAC
CTTATTGCCCT -> TTATTGCCCTT
CTTCAAGTTTC -> TTCAAGTTTCA
CTTCAGTCAGC -> TTCAGTCAGCA
CTTCAGTGCTT -> TTCAGTGCTTG
CTTCCTAGTAA -> TTCCTAGTAAA
CTTCGCTATTC -> TTCGCTATTCA
CTTCGTCCGAC -> TTCGTCCGACT
CTTCTGGATAA -> TTCTGGATAAG
CTTGAAGGGTT -> TTGAAGGGTTA
CTTGACAGGCT -> TTGACAGGCTC
CTTGACCCTGG -> TTGACCCTGGA
CTTGATTTAGC -> TTGATTTAGCC
CTTGCCTGCAA -> TTGCCTGCAAG
CTTGTACTAGA -> TTGTACTAGAT
CTTGTAGTACT -> TTGTAGTACTA
CTTGTGTATAC -> TTGTGTATACG
CTTGTTATATT -> TTGTTATATTC
CTTTAGAGGGT -> TTTAGAGGGTG
CTTTCATGACA -> TTTCATGACAG
CTTTGAAACGC -> TTTGAAACGCA
CTTTGAAGAAC -> TTTGAAGAACG
CTTTGCCCGGA -> TTTGCCCGGAC
CTTTTAGCTTA -> TTTTAGCTTAC
GAAAAACACGT -> AAAAACACGTG
GAAAACTTTGA -> AAAACTTTGAA
GAAACGCAAAC -> AAACGCAAACG
GAAACTAAGAA -> AAACTAAGAAC
GAAAGCAACTA -> AAAGCAACTAA
GAAAGCCTTCC -> AAAGCCTTCCT
GAAAGGGTATT -> AAAGGGTATTC
GAAATGCTCTC -> AAATGCTCTCG
GAAATTGATGA -> AAATTGATGAT
GAACACTGACT -> AACACTGACTT
GAACAGCTACG -> AACAGCTACGC
GAACCACGGAG -> AACCACGGAGT
GAACCCCAGAC -> AACCCCAGACA
GAACCTTCGTC -> AACCTTCGTCC
GAACGCCTAAG -> AACGCCTAAGA
GAACGGTAGCT -> AACGGTAGCTG
GAACTATATCG -> AACTATATCGG
GAACTCTAGCC -> AACTCTAGCCG
GAACTTATTGA -> AACTTATTGAA
GAACTTATTGC -> AACTTATTGCC
GAAGAACGGTA -> AAGAACGGTAG
GAAGACAGCTG -> AAGACAGCTGT
GAAGACCGCAG -> AAGACCGCAGG
GAAGATAATAT -> AAGATAATATG
GAAGCCCGTGG -> AAGCCCGTGGG
GAAGGGTTAAA -> AAGGGTTAAAA
GAAGTACAAGA -> AAGTACAAGAC
GAAGTACAGAT -> AAGTACAGATC
GAAGTGCACGT -> AAGTGCACGTA
GAATACCGTGA -> AATACCGTGAC
GAATACGAGAT -> AATACGAGATA
GAATCTTAGCG -> AATCTTAGCGA
GAATGACGACT -> AATGACGACTC
GAATGCCATAA -> AATGCCATAAC
GAATGGGAGCC -> AATGGGAGCCC
GAATGGTCAGA -> AATGGTCAGAT
GAATTTTACAG -> AATTTTACAGA
GACAAACCAGA -> ACAAACCAGAA
GACAATACGGC -> ACAATACGGCT
GACACGTTCGC -> ACACGTTCGCC
GACAGCATCGC -> ACAGCATCGCA
GACAGCTGTAG -> ACAGCTGTAGT
GACAGGCTCTA -> ACAGGCTCTAC
GACATATTATG -> ACATATTATGG
GACATTAAGTG -> ACATTAAGTGA
GACATTGGCTG -> ACATTGGCTGT
GACCAGACTTG -> ACCAGACTTGT
GACCCTACCGA -> ACCCTACCGAT
GACCCTGGAGC -> ACCCTGGAGCC
GACCGAAATTG -> ACCGAAATTGA
GACCGACTACA -> ACCGACTACAT
GACCGCAGGAT -> ACCGCAGGATA
GACCGTGGCTT -> ACCGTGGCTTC
GACCTACGTTT -> ACCTACGTTTC
GACCTCTGTCC -> ACCTCTGTCCC
GACGACTCATC -> ACGACTCATCA
GACGAGTGAGG -> ACGAGTGAGGG
GACGCGCTCAT -> ACGCGCTCATT
GACGCGTTCCT -> ACGCGTTCCTT
GACGTGTTGCT -> ACGTGTTGCTG
GACGTTCCGGG -> ACGTTCCGGGC
GACTACATCTA -> ACTACATCTAT
GACTCATCAAC -> ACTCATCAACG
GACTCTGAGTT -> ACTCTGAGTTG
GACTCTGTTCT -> ACTCTGTTCTC
GACTGATGTCG -> ACTGATGTCGA
GACTTAATACA -> ACTTAATACAA
GACTTACCTGA -> ACTTACCTGAT
GACTTCAAGTT -> ACTTCAAGTTT
GACTTGACAGG -> ACTTGACAGGC
GACTTGCCTGC -> ACTTGCCTGCA
GACTTGTACTA -> ACTTGTACTAG
GAGAACTATAT -> AGAACTATATC
GAGACCGACTA -> AGACCGACTAC
GAGAGCCGTTA -> AGAGCCGTTAG
GAGAGCTGCAG -> AGAGCTGCAGC
GAGATACGTGC -> AGATACGTGCG
GAGATCCAATG -> AGATCCAATGT
GAGATCTCGAA -> AGATCTCGAAT
GAGATGCGTGC -> AGATGCGTGCG
GAGCCAATACA -> AGCCAATACAC
GAGCCCATGCG -> AGCCCATGCGA
GAGCCCCTTCA -> AGCCCCTTCAG
GAGCCGCGACA -> AGCCGCGACAA
GAGCCGGGATG -> AGCCGGGATGC
GAGCCGTTAGC -> AGCCGTTAGCC
GAGCTACTGGG -> AGCTACTGGGC
GAGCTGCAGCC -> AGCTGCAGCCC
GAGGAGGCACG -> AGGAGGCACGA
GAGGCACGAGT -> AGGCACGAGTG
GAGGGCCGATA -> AGGGCCGATAG
GAGGGGCAAAG -> AGGGGCAAAGG
GAGGGTGAATA -> AGGGTGAATAC
GAGGGTGTATA -> AGGGTGTATAC
GAGGTTTCATA -> AGGTTTCATAC
GAGTCTGTTGA -> AGTCTGTTGAG
GAGTGAGGGGC -> AGTGAGGGGCA
GAGTGTACAGT -> AGTGTACAGTG
GAGTGTGATAT -> AGTGTGATATC
GAGTGTGCACC -> AGTGTGCACCT
GAGTGTGTGAG -> AGTGTGTGAGA
GAGTGTTCCCG -> AGTGTTCCCGG
GAGTTAGCCTC -> AGTTAGCCTCG
GAGTTCGACTC -> AGTTCGACTCT
GAGTTGATTTT -> AGTTGATTTTT
GAGTTGGGTAA -> AGTTGGGTAAT
GAGTTGTCGCG -> AGTTGTCGCGG
GAGTTTAGGTC -> AGTTTAGGTCG
GATAAAGCAAT -> ATAAAGCAATT
GATAAATTAAC -> ATAAATTAACG
GATAAGAATGG -> ATAAGAATGGT
GATAATATGTG -> ATAATATGTGC
GATACAGGATT -> ATACAGGATTG
GATACGTGCGA -> ATACGTGCGAC
GATAGAGCCGG -> ATAGAGCCGGG
GATATCCGACA -> ATATCCGACAT
GATATCCGGAC -> ATATCCGGACG
GATATGATTTA -> ATATGATTTAA
GATATTTGTAG -> ATATTTGTAGT
GATCCAATGTA -> ATCCAATGTAT
GATCCGTCGTT -> ATCCGTCGTTA
GATCCTGCAGT -> ATCCTGCAGTT
GATCGACTTGA -> ATCGACTTGAC
GATCGCCTTAA -> ATCGCCTTAAC
GATCGCGGTAA -> ATCGCGGTAAT
GATCTCGAATC -> ATCTCGAATCT
GATCTTGAAGG -> ATCTTGAAGGG
GATCTTGTGTA -> ATCTTGTGTAT
GATGAATGACG -> ATGAATGACGA
GATGAGCCAAT -> ATGAGCCAATA
GATGATAAATT -> ATGATAAATTA
GATGATCGACT -> ATGATCGACTT
GATGATTCGTT -> ATGATTCGTTC
GATGCACGTTC -> ATGCACGTTCG
GATGCGTGCGT -> ATGCGTGCGTG
GATGCTACGGG -> ATGCTACGGGT
GATGGGCAGAA -> ATGGGCAGAAG
GATGTACCTGC -> ATGTACCTGCA
GATGTATATTC -> ATGTATATTCA
GATGTCGATGG -> ATGTCGATGGG
GATGTGACTGA -> ATGTGACTGAT
GATTCGTAGAC -> ATTCGTAGACC
GATTCGTTCGG -> ATTCGTTCGGC
GATTGTTCCAA -> ATTGTTCCAAC
GATTTAAGATC -> ATTTAAGATCC
GATTTAGCCTT -> ATTTAGCCTTA
GATTTTTAATC -> ATTTTTAATCA
GCAAAAACAGA -> CAAAAACAGAG
GCAAAAGTTAG -> CAAAAGTTAGG
GCAAACGAACC -> CAAACGAACCT
GCAAAGGGGAA -> CAAAGGGGAAA
GCAACGAAAGC -> CAACGAAAGCA
GCAACTAAACT -> CAACTAAACTC
GCAAGTCTCGC -> CAAGTCTCGCC
GCAATCGTGGG -> CAATCGTGGGT
GCAATGTCTCC -> CAATGTCTCCT
GCAATTGTACG -> CAATTGTACGG
GCACAGTAGAG -> CACAGTAGAGA
GCACCCTAGAG -> CACCCTAGAGG
GCACCTACAGC -> CACCTACAGCA
GCACCTCAATT -> CACCTCAATTA
GCACGAACACT -> CACGAACACTG
GCACGAGTGTG -> CACGAGTGTGC
GCACGTAGCAC -> CACGTAGCACG
GCACGTGCCGA -> CACGTGCCGAC
GCACGTGTTGG -> CACGTGTTGGA
GCACGTTCGAA -> CACGTTCGAAA
GCAGAAGACAG -> CAGAAGACAGC
GCAGAAGACCG -> CAGAAGACCGC
GCAGCCCCCAG -> CAGCCCCCAGC
GCAGGATATGA -> CAGGATATGAT
GCAGGATGAAT -> CAGGATGAATG
GCAGGCATCCG -> CAGGCATCCGG
GCAGGCGGGTC -> CAGGCGGGTCA
GCAGGTTGATG -> CAGGTTGATGT
GCAGTTATTAT -> CAGTTATTATG
GCATCCGGCTC -> CATCCGGCTCC
GCATCGCAGGC -> CATCGCAGGCG
GCATGGTGAGT -> CATGGTGAGTT
GCATTAGTGTG -> CATTAGTGTGT
GCATTTAGTGC -> CATTTAGTGCA
GCCAACGACAT -> CCAACGACATT
GCCAATACACT -> CCAATACACTA
GCCACCGAGTG -> CCACCGAGTGT
GCCAGAGCCGC -> CCAGAGCCGCG
GCCATAACCCC -> CCATAACCCCA
GCCATAGGGGA -> CCATAGGGGAA
GCCCATCGCCA -> CCCATCGCCAA
GCCCATGCGAG -> CCCATGCGAGG
GCCCCCAGCAG -> CCCCCAGCAGG
GCCCCGGATCC -> CCCCGGATCCT
GCCCCGTAAGG -> CCCCGTAAGGC
GCCCCTTCAGT -> CCCCTTCAGTG
GCCCGGACTTA -> CCCGGACTTAA
GCCCGGGAAAA -> CCCGGGAAAAA
GCCCGTGGGAA -> CCCGTGGGAAG
GCCCTTACAAG -> CCCTTACAAGC
GCCGAACCACG -> CCGAACCACGG
GCCGACACGTT -> CCGACACGTTC
GCCGACATATT -> CCGACATATTA
GCCGAGGGCCG -> CCGAGGGCCGA
GCCGATAGAGC -> CCGATAGAGCC
GCCGCGACAAA -> CCGCGACAAAC
GCCGGGATGCT -> CCGGGATGCTA
GCCGTCGGACC -> CCGTCGGACCG
GCCGTTAGCCA -> CCGTTAGCCAT
GCCTAAGATTC -> CCTAAGATTCG
GCCTAGCCGAC -> CCTAGCCGACA
GCCTCGCACGA -> CCTCGCACGAA
GCCTGCAAGTC -> CCTGCAAGTCT
GCCTGTAGATA -> CCTGTAGATAA
GCCTTAACCAT -> CCTTAACCATT
GCCTTAGTATG -> CCTTAGTATGA
GCCTTATGGCA -> CCTTATGGCAC
GCCTTCCTAGT -> CCTTCCTAGTA
GCGACAAACCA -> CGACAAACCAG
GCGACCAGACT -> CGACCAGACTT
GCGAGGGTGAA -> CGAGGGTGAAT
GCGATATTTGT -> CGATATTTGTA
GCGCCCGGGAA -> CGCCCGGGAAA
GCGCTCATTGA -> CGCTCATTGAA
GCGGGCCTAGC -> CGGGCCTAGCC
GCGGGGTCTTT -> CGGGGTCTTTA
GCGGGTCACGC -> CGGGTCACGCT
GCGGTAATCGC -> CGGTAATCGCG
GCGGTCCATCG -> CGGTCCATCGC
GCGGTGGGCTT -> CGGTGGGCTTC
GCGTATGAAAA -> CGTATGAAAAC
GCGTCGTACAC -> CGTCGTACACC
GCGTGACTTGC -> CGTGACTTGCC
GCGTGATGCAC -> CGTGATGCACG
GCGTGCGTGAT -> CGTGCGTGATG
GCGTTCCTTGT -> CGTTCCTTGTT
GCTACGCAATG -> CTACGCAATGT
GCTACGGGTTC -> CTACGGGTTCC
GCTACTGGGCG -> CTACTGGGCGC
GCTATGTCCTT -> CTATGTCCTTA
GCTATTCAATA -> CTATTCAATAC
GCTATTCCGCC -> CTATTCCGCCC
GCTCATTGAAC -> CTCATTGAACT
GCTCCCAGTTC -> CTCCCAGTTCG
GCTCCGAAGTA -> CTCCGAAGTAC
GCTCCTCATCT -> CTCCTCATCTG
GCTCGTCTTTG -> CTCGTCTTTGC
GCTCTACCAGC -> CTCTACCAGCC
GCTCTCGGCGG -> CTCTCGGCGGT
GCTGAGTGTGT -> CTGAGTGTGTG
GCTGCAGCCCC -> CTGCAGCCCCC
GCTGCCTTAGT -> CTGCCTTAGTA
GCTGCGTGACT -> CTGCGTGACTT
GCTGGAGTGTT -> CTGGAGTGTTC
GCTGGCTGAGT -> CTGGCTGAGTG
GCTGGGGGCTT -> CTGGGGGCTTC
GCTGTAGTTCG -> CTGTAGTTCGA
GCTGTTTCTGG -> CTGTTTCTGGC
GCTTAAATCAC -> CTTAAATCACG
GCTTACGTGCG -> CTTACGTGCGG
GCTTCAGTCAG -> CTTCAGTCAGC
GCTTCGCTATT -> CTTCGCTATTC
GCTTCTGGATA -> CTTCTGGATAA
GCTTGATTTAG -> CTTGATTTAGC
GCTTGTAGTAC -> CTTGTAGTACT
GCTTTTAGCTT -> CTTTTAGCTTA
GGAAAAACACG -> GAAAAACACGT
GGAAACTAAGA -> GAAACTAAGAA
GGAAAGCCTTC -> GAAAGCCTTCC
GGAACCCCAGA -> GAACCCCAGAC
GGAAGTACAGA -> GAAGTACAGAT
GGAAGTGCACG -> GAAGTGCACGT
GGAATTTTACA -> GAATTTTACAG
GGACCGAAATT -> GACCGAAATTG
GGACGCGTTCC -> GACGCGTTCCT
GGACTTAATAC -> GACTTAATACA
GGAGCCCATGC -> GAGCCCATGCG
GGAGCCCCTTC -> GAGCCCCTTCA
GGAGGAGGCAC -> GAGGAGGCACG
GGAGGCACGAG -> GAGGCACGAGT
GGAGTCTGTTG -> GAGTCTGTTGA
GGAGTGTTCCC -> GAGTGTTCCCG
GGAGTTGGGTA -> GAGTTGGGTAA
GGATAAGAATG -> GATAAGAATGG
GGATATGATTT -> GATATGATTTA
GGATCCTGCAG -> GATCCTGCAGT
GGATCGCCTTA -> GATCGCCTTAA
GGATCTTGAAG -> GATCTTGAAGG
GGATGAATGAC -> GATGAATGACG
GGATGAGCCAA -> GATGAGCCAAT
GGATGCTACGG -> GATGCTACGGG
GGATTGTTCCA -> GATTGTTCCAA
GGCAAAGGGGA -> GCAAAGGGGAA
GGCAATCGTGG -> GCAATCGTGGG
GGCACCCTAGA -> GCACCCTAGAG
GGCACCTACAG -> GCACCTACAGC
GGCACGAGTGT -> GCACGAGTGTG
GGCACGTGCCG -> GCACGTGCCGA
GGCAGAAGACA -> GCAGAAGACAG
GGCATCCGGCT -> GCATCCGGCTC
GGCCAGAGCCG -> GCCAGAGCCGC
GGCCCATCGCC -> GCCCATCGCCA
GGCCGAGGGCC -> GCCGAGGGCCG
GGCCGATAGAG -> GCCGATAGAGC
GGCCTAGCCGA -> GCCTAGCCGAC
GGCGCCCGGGA -> GCGCCCGGGAA
GGCGGGGTCTT -> GCGGGGTCTTT
GGCGGGTCACG -> GCGGGTCACGC
GGCGGTGGGCT -> GCGGTGGGCTT
GGCGTCGTACA -> GCGTCGTACAC
GGCTCCCAGTT -> GCTCCCAGTTC
GGCTCCTCATC -> GCTCCTCATCT
GGCTCGTCTTT -> GCTCGTCTTTG
GGCTCTACCAG -> GCTCTACCAGC
GGCTGAGTGTG -> GCTGAGTGTGT
GGCTGGAGTGT -> GCTGGAGTGTT
GGCTGTTTCTG -> GCTGTTTCTGG
GGCTTCAGTCA -> GCTTCAGTCAG
GGCTTCGCTAT -> GCTTCGCTATT
GGCTTCTGGAT -> GCTTCTGGATA
GGCTTGATTTA -> GCTTGATTTAG
GGCTTTTAGCT -> GCTTTTAGCTT
GGGAAAAACAC -> GGAAAAACACG
GGGAAACTAAG -> GGAAACTAAGA
GGGAAAGCCTT -> GGAAAGCCTTC
GGGAACCCCAG -> GGAACCCCAGA
GGGAAGTACAG -> GGAAGTACAGA
GGGAGCCCCTT -> GGAGCCCCTTC
GGGATGCTACG -> GGATGCTACGG
GGGCAAAGGGG -> GGCAAAGGGGA
GGGCAGAAGAC -> GGCAGAAGACA
GGGCCGATAGA -> GGCCGATAGAG
GGGCCTAGCCG -> GGCCTAGCCGA
GGGCGCCCGGG -> GGCGCCCGGGA
GGGCTCGTCTT -> GGCTCGTCTTT
GGGCTTCGCTA -> GGCTTCGCTAT
GGGCTTCTGGA -> GGCTTCTGGAT
GGGCTTGATTT -> GGCTTGATTTA
GGGGAAACTAA -> GGGAAACTAAG
GGGGAAAGCCT -> GGGAAAGCCTT
GGGGCAAAGGG -> GGGCAAAGGGG
GGGGCTTCGCT -> GGGCTTCGCTA
GGGGCTTGATT -> GGGCTTGATTT
GGGGGCTTCGC -> GGGGCTTCGCT
GGGGGCTTGAT -> GGGGCTTGATT
GGGGGGCTTGA -> GGGGGCTTGAT
GGGGTCTTTAG -> GGGTCTTTAGA
GGGTAATAATC -> GGTAATAATCT
GGGTATTCTAC -> GGTATTCTACG
GGGTCACGCTG -> GGTCACGCTGG
GGGTCTTTAGA -> GGTCTTTAGAG
GGGTGAATACG -> GGTGAATACGA
GGGTGACGTGT -> GGTGACGTGTT
GGGTGTATACT -> GGTGTATACTT
GGGTTAAAATT -> GGTTAAAATTG
GGGTTCCCCGA -> GGTTCCCCGAG
GGTAATAATCT -> GTAATAATCTA
GGTAATCGCGT -> GTAATCGCGTA
GGTACGGAATT -> GTACGGAATTT
GGTAGCTGCGT -> GTAGCTGCGTG
GGTATTACCGG -> GTATTACCGGT
GGTATTCTACG -> GTATTCTACGT
GGTCACGCTGG -> GTCACGCTGGG
GGTCAGATACA -> GTCAGATACAG
GGTCCATCGCT -> GTCCATCGCTG
GGTCCGGCACG -> GTCCGGCACGT
GGTCTAAGTGA -> GTCTAAGTGAC
GGTCTACAGGA -> GTCTACAGGAT
GGTCTTTAGAG -> GTCTTTAGAGG
GGTGAATACGA -> GTGAATACGAG
GGTGACGTGTT -> GTGACGTGTTG
GGTGAGTTGAT -> GTGAGTTGATT
GGTGCAGGCAT -> GTGCAGGCATC
GGTGCTTAAAT -> GTGCTTAAATC
GGTGGGCTTCT -> GTGGGCTTCTG
GGTGTATACTT -> GTGTATACTTT
GGTTAAAATTG -> GTTAAAATTGC
GGTTCCCCGAG -> GTTCCCCGAGT
GGTTCGTCGTG -> GTTCGTCGTGG
GGTTGATGTGA -> GTTGATGTGAC
GGTTTCATACG -> GTTTCATACGT
GGTTTGTCGCT -> GTTTGTCGCTA
GTAAAGAATGG -> TAAAGAATGGG
GTAAGGCACCT -> TAAGGCACCTA
GTAATAATCTA -> TAATAATCTAA
GTAATCGCGTA -> TAATCGCGTAT
GTACAAGACCT -> TACAAGACCTA
GTACACCGAGA -> TACACCGAGAG
GTACAGATCTT -> TACAGATCTTG
GTACAGTGTGA -> TACAGTGTGAA
GTACCTGCACA -> TACCTGCACAG
GTACGGAATTT -> TACGGAATTTT
GTACGGTTTGT -> TACGGTTTGTC
GTACTAGATAT -> TACTAGATATC
GTACTAGCAGA -> TACTAGCAGAA
GTAGACCTCTG -> TAGACCTCTGT
GTAGAGACCGA -> TAGAGACCGAC
GTAGATAAAGC -> TAGATAAAGCA
GTAGCACGTGT -> TAGCACGTGTT
GTAGCTGCGTG -> TAGCTGCGTGA
GTAGGTCTAAG -> TAGGTCTAAGT
GTAGTACTAGC -> TAGTACTAGCA
GTAGTTACCTT -> TAGTTACCTTT
GTAGTTCGAAC -> TAGTTCGAACT
GTATACGTTAT -> TATACGTTATG
GTATACTTTCA -> TATACTTTCAT
GTATATTCACG -> TATATTCACGA
GTATGAAAACT -> TATGAAAACTT
GTATGACGAGT -> TATGACGAGTG
GTATGTAGGTC -> TATGTAGGTCT
GTATTACCGGT -> TATTACCGGTT
GTATTCTACGT -> TATTCTACGTT
GTCACGCTGGG -> TCACGCTGGGG
GTCAGAACAGC -> TCAGAACAGCT
GTCAGATACAG -> TCAGATACAGG
GTCAGCATTTA -> TCAGCATTTAG
GTCCATCGCTG -> TCCATCGCTGG
GTCCCTACTAG -> TCCCTACTAGT
GTCCGACTTCA -> TCCGACTTCAA
GTCCGGCACGT -> TCCGGCACGTG
GTCCTTAAAAC -> TCCTTAAAACA
GTCGATGGGCA -> TCGATGGGCAG
GTCGCGGTCCA -> TCGCGGTCCAT
GTCGCTATTCC -> TCGCTATTCCG
GTCGGACCGAA -> TCGGACCGAAA
GTCGTACACCG -> TCGTACACCGA
GTCGTGGTCCG -> TCGTGGTCCGG
GTCGTTAACCC -> TCGTTAACCCA
GTCGTTCCATA -> TCGTTCCATAA
GTCTAAGTGAC -> TCTAAGTGACC
GTCTACAGGAT -> TCTACAGGATC
GTCTCCTTGAC -> TCTCCTTGACC
GTCTCGCCTGT -> TCTCGCCTGTA
GTCTGTTGAGA -> TCTGTTGAGAT
GTCTTTAGAGG -> TCTTTAGAGGG
GTCTTTGCCCG -> TCTTTGCCCGG
GTGAAATGCTC -> TGAAATGCTCT
GTGAAGATAAT -> TGAAGATAATA
GTGAATACGAG -> TGAATACGAGA
GTGACCCTACC -> TGACCCTACCG
GTGACGCGCTC -> TGACGCGCTCA
GTGACGTGTTG -> TGACGTGTTGC
GTGACTGATGT -> TGACTGATGTC
GTGACTTGCCT -> TGACTTGCCTG
GTGAGAGCCGT -> TGAGAGCCGTT
GTGAGGGGCAA -> TGAGGGGCAAA
GTGAGTTGATT -> TGAGTTGATTT
GTGAGTTTAGG -> TGAGTTTAGGT
GTGATATCCGG -> TGATATCCGGA
GTGATGCACGT -> TGATGCACGTT
GTGCAAAAACA -> TGCAAAAACAG
GTGCACCTCAA -> TGCACCTCAAT
GTGCACGTAGC -> TGCACGTAGCA
GTGCAGGCATC -> TGCAGGCATCC
GTGCCGACACG -> TGCCGACACGT
GTGCGACCAGA -> TGCGACCAGAC
GTGCGGGCCTA -> TGCGGGCCTAG
GTGCGTGATGC -> TGCGTGATGCA
GTGCTATGTCC -> TGCTATGTCCT
GTGCTTAAATC -> TGCTTAAATCA
GTGCTTGTAGT -> TGCTTGTAGTA
GTGGCTTCAGT -> TGGCTTCAGTC
GTGGGAAGTAC -> TGGGAAGTACA
GTGGGCTTCTG -> TGGGCTTCTGG
GTGGGTGACGT -> TGGGTGACGTG
GTGGTCCGGCA -> TGGTCCGGCAC
GTGGTGCAGGC -> TGGTGCAGGCA
GTGTACAGTGT -> TGTACAGTGTG
GTGTATACGTT -> TGTATACGTTA
GTGTATACTTT -> TGTATACTTTC
GTGTCAGAACA -> TGTCAGAACAG
GTGTGAAGATA -> TGTGAAGATAA
GTGTGAGAGCC -> TGTGAGAGCCG
GTGTGATATCC -> TGTGATATCCG
GTGTGCACCTC -> TGTGCACCTCA
GTGTGTCAGAA -> TGTGTCAGAAC
GTGTGTGAGAG -> TGTGTGAGAGC
GTGTTCCCGGT -> TGTTCCCGGTG
GTGTTGCTGCC -> TGTTGCTGCCT
GTGTTGGAGGA -> TGTTGGAGGAG
GTTAAAATTGC -> TTAAAATTGCA
GTTAACCCAGA -> TTAACCCAGAC
GTTACCTTTGA -> TTACCTTTGAA
GTTAGCCATAG -> TTAGCCATAGG
GTTAGCCTCGC -> TTAGCCTCGCA
GTTAGGCAATC -> TTAGGCAATCG
GTTAGTTGGTA -> TTAGTTGGTAT
GTTATATTCGG -> TTATATTCGGT
GTTATGAGCTA -> TTATGAGCTAC
GTTATTATGCT -> TTATTATGCTC
GTTCATCTATC -> TTCATCTATCA
GTTCCAACGGC -> TTCCAACGGCT
GTTCCATAATG -> TTCCATAATGA
GTTCCCCGAGT -> TTCCCCGAGTT
GTTCCCGGTGC -> TTCCCGGTGCT
GTTCCGGGCTC -> TTCCGGGCTCG
GTTCCTTGTTA -> TTCCTTGTTAT
GTTCGAAAGGG -> TTCGAAAGGGT
GTTCGAACTTA -> TTCGAACTTAT
GTTCGACTCTG -> TTCGACTCTGT
GTTCGAGATGC -> TTCGAGATGCG
GTTCGCCGAAC -> TTCGCCGAACC
GTTCGGCTCCT -> TTCGGCTCCTC
GTTCGTCGTGG -> TTCGTCGTGGT
GTTCTCCCTGC -> TTCTCCCTGCA
GTTGAGATCCA -> TTGAGATCCAA
GTTGATGATAA -> TTGATGATAAA
GTTGATGTGAC -> TTGATGTGACT
GTTGATTTTTA -> TTGATTTTTAA
GTTGCTGCCTT -> TTGCTGCCTTA
GTTGGAGGAGG -> TTGGAGGAGGC
GTTGGGTAATA -> TTGGGTAATAA
GTTGGTATTAC -> TTGGTATTACC
GTTGTCGCGGT -> TTGTCGCGGTC
GTTTAGGTCGT -> TTTAGGTCGTA
GTTTCAGATGA -> TTTCAGATGAT
GTTTCAGTTAG -> TTTCAGTTAGT
GTTTCATACGT -> TTTCATACGTC
GTTTCTGGCGG -> TTTCTGGCGGG
GTTTGTCGCTA -> TTTGTCGCTAT
TAAAACAATCT -> AAAACAATCTA
TAAAATTGCAG -> AAAATTGCAGG
TAAACTCGGGA -> AAACTCGGGAA
TAAAGAATGGG -> AAAGAATGGGA
TAAAGCAATTG -> AAAGCAATTGT
TAAATCACGAG -> AAATCACGAGA
TAAATTAACGC -> AAATTAACGCA
TAACCATTAGT -> AACCATTAGTG
TAACCCAGACT -> AACCCAGACTC
TAACCCCAAAG -> AACCCCAAAGG
TAACCCCTCCC -> AACCCCTCCCC
TAACGCATGGT -> AACGCATGGTG
TAAGAACGCCT -> AAGAACGCCTA
TAAGAATGGTC -> AAGAATGGTCA
TAAGATCCGTC -> AAGATCCGTCG
TAAGATTCGTA -> AAGATTCGTAG
TAAGGCACCTA -> AAGGCACCTAC
TAAGGCGTCGT -> AAGGCGTCGTA
TAAGTGAAATG -> AAGTGAAATGC
TAAGTGACCCT -> AAGTGACCCTA
TAATAATCTAA -> AATAATCTAAG
TAATACAAACC -> AATACAAACCG
TAATATGTGCT -> AATATGTGCTA
TAATCAGGAAG -> AATCAGGAAGT
TAATCGCGTAT -> AATCGCGTATG
TAATCTAAGGC -> AATCTAAGGCG
TAATGACGTTC -> AATGACGTTCC
TACAAACCGCA -> ACAAACCGCAT
TACAAGACCTA -> ACAAGACCTAC
TACAAGCCCCG -> ACAAGCCCCGT
TACACCGAGAG -> ACACCGAGAGC
TACACTATTAG -> ACACTATTAGA
TACAGAGTGTA -> ACAGAGTGTAC
TACAGATCTTG -> ACAGATCTTGT
TACAGCAAAAG -> ACAGCAAAAGT
TACAGGATCTT -> ACAGGATCTTG
TACAGGATTGT -> ACAGGATTGTT
TACAGTGTGAA -> ACAGTGTGAAG
TACATCTATCC -> ACATCTATCCG
TACCAGCCACC -> ACCAGCCACCG
TACCGATGTAC -> ACCGATGTACC
TACCGGTTCGT -> ACCGGTTCGTC
TACCGTGACGC -> ACCGTGACGCG
TACCTGATCGC -> ACCTGATCGCG
TACCTGCACAG -> ACCTGCACAGT
TACCTTTGAAA -> ACCTTTGAAAC
TACGAGATACG -> ACGAGATACGT
TACGATGTATA -> ACGATGTATAT
TACGCAATGTC -> ACGCAATGTCT
TACGGAATTTT -> ACGGAATTTTA
TACGGAGTCTG -> ACGGAGTCTGT
TACGGCTGGAG -> ACGGCTGGAGT
TACGGGTTCCC -> ACGGGTTCCCC
TACGGTTTGTC -> ACGGTTTGTCG
TACGTCGTTCC -> ACGTCGTTCCA
TACGTGCGACC -> ACGTGCGACCA
TACGTGCGGGC -> ACGTGCGGGCC
TACGTTATGAG -> ACGTTATGAGC
TACGTTGATGA -> ACGTTGATGAT
TACGTTTCAGT -> ACGTTTCAGTT
TACTAGATATC -> ACTAGATATCC
TACTAGCAGAA -> ACTAGCAGAAG
TACTAGTTCAT -> ACTAGTTCATC
TACTGGGCGCC -> ACTGGGCGCCC
TACTTTCATGA -> ACTTTCATGAC
TAGAAGCCCGT -> AGAAGCCCGTG
TAGACCTCTGT -> AGACCTCTGTC
TAGAGACCGAC -> AGAGACCGACT
TAGAGCCGGGA -> AGAGCCGGGAT
TAGAGGGTGTA -> AGAGGGTGTAT
TAGAGGTTTCA -> AGAGGTTTCAT
TAGATAAAGCA -> AGATAAAGCAA
TAGATATCCGA -> AGATATCCGAC
TAGCACGTGTT -> AGCACGTGTTG
TAGCAGAAGAC -> AGCAGAAGACC
TAGCCATAGGG -> AGCCATAGGGG
TAGCCGACATA -> AGCCGACATAT
TAGCCGTCGGA -> AGCCGTCGGAC
TAGCCTCGCAC -> AGCCTCGCACG
TAGCCTTATGG -> AGCCTTATGGC
TAGCGATATTT -> AGCGATATTTG
TAGCTGCGTGA -> AGCTGCGTGAC
TAGCTTACGTG -> AGCTTACGTGC
TAGGCAATCGT -> AGGCAATCGTG
TAGGGGAAACT -> AGGGGAAACTA
TAGGTCGTAAT -> AGGTCGTAATG
TAGGTCTAAGT -> AGGTCTAAGTG
TAGTAAAGAAT -> AGTAAAGAATG
TAGTACTAGCA -> AGTACTAGCAG
TAGTATGACGA -> AGTATGACGAG
TAGTGAGTTTA -> AGTGAGTTTAG
TAGTGCAAAAA -> AGTGCAAAAAC
TAGTGTGTCAG -> AGTGTGTCAGA
TAGTTACCTTT -> AGTTACCTTTG
TAGTTCATCTA -> AGTTCATCTAT
TAGTTCGAACT -> AGTTCGAACTT
TAGTTGGTATT -> AGTTGGTATTA
TATACGTTATG -> ATACGTTATGA
TATACTTTCAT -> ATACTTTCATG
TATATCGGATG -> ATATCGGATGA
TATATTCACGA -> ATATTCACGAA
TATATTCGGTC -> ATATTCGGTCT
TATCAGACCGT -> ATCAGACCGTG
TATCCGACATT -> ATCCGACATTA
TATCCGGACGC -> ATCCGGACGCG
TATCCGGGGGG -> ATCCGGGGGGC
TATCGGATGAG -> ATCGGATGAGC
TATGAAAACTT -> ATGAAAACTTT
TATGACGAGTG -> ATGACGAGTGA
TATGAGCTACT -> ATGAGCTACTG
TATGATTTAAG -> ATGATTTAAGA
TATGCTCCGAA -> ATGCTCCGAAG
TATGGCACCCT -> ATGGCACCCTA
TATGGTACGGA -> ATGGTACGGAA
TATGTAGGTCT -> ATGTAGGTCTA
TATGTCCTTAA -> ATGTCCTTAAA
TATGTGCTATG -> ATGTGCTATGT
TATTACCGGTT -> ATTACCGGTTC
TATTAGAAGCC -> ATTAGAAGCCC
TATTATGCTCC -> ATTATGCTCCG
TATTATGGTAC -> ATTATGGTACG
TATTCAATACG -> ATTCAATACGA
TATTCACGAAC -> ATTCACGAACT
TATTCCGCCCC -> ATTCCGCCCCG
TATTCGGTCTA -> ATTCGGTCTAC
TATTCTACGTT -> ATTCTACGTTG
TATTGAATACC -> ATTGAATACCG
TATTGCCCTTA -> ATTGCCCTTAC
TATTTGTAGTT -> ATTTGTAGTTA
TCAACGGCCGA -> CAACGGCCGAG
TCAAGTTTCAG -> CAAGTTTCAGA
TCAATACGATG -> CAATACGATGT
TCAATTACGGA -> CAATTACGGAG
TCACGAACTTA -> CACGAACTTAT
TCACGAGAACT -> CACGAGAACTA
TCACGCTGGGG -> CACGCTGGGGG
TCAGAACAGCT -> CAGAACAGCTA
TCAGACCGTGG -> CAGACCGTGGC
TCAGATACAGG -> CAGATACAGGA
TCAGATGATCG -> CAGATGATCGA
TCAGCATTTAG -> CAGCATTTAGT
TCAGGAAGTGC -> CAGGAAGTGCA
TCAGTCAGCAT -> CAGTCAGCATT
TCAGTGCTTGT -> CAGTGCTTGTA
TCAGTTAGTTG -> CAGTTAGTTGG
TCATACGTCGT -> CATACGTCGTT
TCATCAACGGC -> CATCAACGGCC
TCATCTATCAG -> CATCTATCAGA
TCATCTGGCCA -> CATCTGGCCAG
TCATGACAGCA -> CATGACAGCAT
TCATTGAACTC -> CATTGAACTCT
TCCAACGGCTT -> CCAACGGCTTT
TCCAATGTATG -> CCAATGTATGT
TCCATAATGAC -> CCATAATGACG
TCCATCGCTGG -> CCATCGCTGGC
TCCCAGTTCGA -> CCCAGTTCGAG
TCCCCGAGTTA -> CCCCGAGTTAG
TCCCCTGGCCC -> CCCCTGGCCCA
TCCCGGTGCTT -> CCCGGTGCTTA
TCCCTACTAGT -> CCCTACTAGTT
TCCCTGCAACG -> CCCTGCAACGA
TCCGAAGTACA -> CCGAAGTACAA
TCCGACATTAA -> CCGACATTAAG
TCCGACTTCAA -> CCGACTTCAAG
TCCGCCCCGGA -> CCGCCCCGGAT
TCCGGACGCGT -> CCGGACGCGTT
TCCGGCACGTG -> CCGGCACGTGC
TCCGGCTCCCA -> CCGGCTCCCAG
TCCGGGCTCGT -> CCGGGCTCGTC
TCCGGGGGGCT -> CCGGGGGGCTT
TCCGTCGTTAA -> CCGTCGTTAAC
TCCTAGTAAAG -> CCTAGTAAAGA
TCCTCATCTGG -> CCTCATCTGGC
TCCTGCAGTTA -> CCTGCAGTTAT
TCCTTAAAACA -> CCTTAAAACAA
TCCTTGACCCT -> CCTTGACCCTG
TCCTTGTTATA -> CCTTGTTATAT
TCGAAAGGGTA -> CGAAAGGGTAT
TCGAACTTATT -> CGAACTTATTG
TCGAATCTTAG -> CGAATCTTAGC
TCGACTCTGTT -> CGACTCTGTTC
TCGACTTGACA -> CGACTTGACAG
TCGAGATGCGT -> CGAGATGCGTG
TCGATGGGCAG -> CGATGGGCAGA
TCGCACGAACA -> CGCACGAACAC
TCGCAGGCGGG -> CGCAGGCGGGT
TCGCCAACGAC -> CGCCAACGACA
TCGCCGAACCA -> CGCCGAACCAC
TCGCCTGTAGA -> CGCCTGTAGAT
TCGCCTTAACC -> CGCCTTAACCA
TCGCGGTAATC -> CGCGGTAATCG
TCGCGGTCCAT -> CGCGGTCCATC
TCGCGTATGAA -> CGCGTATGAAA
TCGCTATTCAA -> CGCTATTCAAT
TCGCTATTCCG -> CGCTATTCCGC
TCGCTGGCTGA -> CGCTGGCTGAG
TCGGACCGAAA -> CGGACCGAAAT
TCGGATGAGCC -> CGGATGAGCCA
TCGGCGGTGGG -> CGGCGGTGGGC
TCGGCTCCTCA -> CGGCTCCTCAT
TCGGGAACCCC -> CGGGAACCCCA
TCGGTCTACAG -> CGGTCTACAGG
TCGTACACCGA -> CGTACACCGAG
TCGTAGACCTC -> CGTAGACCTCT
TCGTCCGACTT -> CGTCCGACTTC
TCGTCGTGGTC -> CGTCGTGGTCC
TCGTCTTTGCC -> CGTCTTTGCCC
TCGTGGGTGAC -> CGTGGGTGACG
TCGTGGTCCGG -> CGTGGTCCGGC
TCGTTAACCCA -> CGTTAACCCAG
TCGTTCCATAA -> CGTTCCATAAT
TCGTTCGGCTC -> CGTTCGGCTCC
TCTAACCCCTC -> CTAACCCCTCC
TCTAAGGCGTC -> CTAAGGCGTCG
TCTAAGTGACC -> CTAAGTGACCC
TCTACAGGATC -> CTACAGGATCT
TCTACCAGCCA -> CTACCAGCCAC
TCTACGTTGAT -> CTACGTTGATG
TCTAGCCGTCG -> CTAGCCGTCGG
TCTATCAGACC -> CTATCAGACCG
TCTATCCGGGG -> CTATCCGGGGG
TCTCCCTGCAA -> CTCCCTGCAAC
TCTCCTTGACC -> CTCCTTGACCC
TCTCGAATCTT -> CTCGAATCTTA
TCTCGCCTGTA -> CTCGCCTGTAG
TCTCGGCGGTG -> CTCGGCGGTGG
TCTGAGTTGTC -> CTGAGTTGTCG
TCTGGATAAGA -> CTGGATAAGAA
TCTGGCCAGAG -> CTGGCCAGAGC
TCTGGCGGGGT -> CTGGCGGGGTC
TCTGTCCCTAC -> CTGTCCCTACT
TCTGTTCTCCC -> CTGTTCTCCCT
TCTGTTGAGAT -> CTGTTGAGATC
TCTTAGCGATA -> CTTAGCGATAT
TCTTGAAGGGT -> CTTGAAGGGTT
TCTTGTGTATA -> CTTGTGTATAC
TCTTTAGAGGG -> CTTTAGAGGGT
TCTTTGCCCGG -> CTTTGCCCGGA
TGAAAACTTTG -> GAAAACTTTGA
TGAAACGCAAA -> GAAACGCAAAC
TGAAATGCTCT -> GAAATGCTCTC
TGAACTCTAGC -> GAACTCTAGCC
TGAAGAACGGT -> GAAGAACGGTA
TGAAGATAATA -> GAAGATAATAT
TGAAGGGTTAA -> GAAGGGTTAAA
TGAATACCGTG -> GAATACCGTGA
TGAATACGAGA -> GAATACGAGAT
TGAATGACGAC -> GAATGACGACT
TGACAGCATCG -> GACAGCATCGC
TGACAGGCTCT -> GACAGGCTCTA
TGACCCTACCG -> GACCCTACCGA
TGACCCTGGAG -> GACCCTGGAGC
TGACGACTCAT -> GACGACTCATC
TGACGAGTGAG -> GACGAGTGAGG
TGACGCGCTCA -> GACGCGCTCAT
TGACGTGTTGC -> GACGTGTTGCT
TGACGTTCCGG -> GACGTTCCGGG
TGACTGATGTC -> GACTGATGTCG
TGACTTACCTG -> GACTTACCTGA
TGACTTGCCTG -> GACTTGCCTGC
TGAGAGCCGTT -> GAGAGCCGTTA
TGAGATCCAAT -> GAGATCCAATG
TGAGCCAATAC -> GAGCCAATACA
TGAGCTACTGG -> GAGCTACTGGG
TGAGGGGCAAA -> GAGGGGCAAAG
TGAGTGTGTGA -> GAGTGTGTGAG
TGAGTTGATTT -> GAGTTGATTTT
TGAGTTGTCGC -> GAGTTGTCGCG
TGAGTTTAGGT -> GAGTTTAGGTC
TGATAAATTAA -> GATAAATTAAC
TGATATCCGGA -> GATATCCGGAC
TGATCGACTTG -> GATCGACTTGA
TGATCGCGGTA -> GATCGCGGTAA
TGATGATAAAT -> GATGATAAATT
TGATGATTCGT -> GATGATTCGTT
TGATGCACGTT -> GATGCACGTTC
TGATGTCGATG -> GATGTCGATGG
TGATGTGACTG -> GATGTGACTGA
TGATTCGTTCG -> GATTCGTTCGG
TGATTTAAGAT -> GATTTAAGATC
TGATTTAGCCT -> GATTTAGCCTT
TGATTTTTAAT -> GATTTTTAATC
TGCAAAAACAG -> GCAAAAACAGA
TGCAACGAAAG -> GCAACGAAAGC
TGCAAGTCTCG -> GCAAGTCTCGC
TGCACAGTAGA -> GCACAGTAGAG
TGCACCTCAAT -> GCACCTCAATT
TGCACGTAGCA -> GCACGTAGCAC
TGCACGTTCGA -> GCACGTTCGAA
TGCAGCCCCCA -> GCAGCCCCCAG
TGCAGGATGAA -> GCAGGATGAAT
TGCAGGCATCC -> GCAGGCATCCG
TGCAGTTATTA -> GCAGTTATTAT
TGCCATAACCC -> GCCATAACCCC
TGCCCGGACTT -> GCCCGGACTTA
TGCCCTTACAA -> GCCCTTACAAG
TGCCGACACGT -> GCCGACACGTT
TGCCTGCAAGT -> GCCTGCAAGTC
TGCCTTAGTAT -> GCCTTAGTATG
TGCGACCAGAC -> GCGACCAGACT
TGCGAGGGTGA -> GCGAGGGTGAA
TGCGGGCCTAG -> GCGGGCCTAGC
TGCGTGACTTG -> GCGTGACTTGC
TGCGTGATGCA -> GCGTGATGCAC
TGCGTGCGTGA -> GCGTGCGTGAT
TGCTACGGGTT -> GCTACGGGTTC
TGCTATGTCCT -> GCTATGTCCTT
TGCTCCGAAGT -> GCTCCGAAGTA
TGCTCTCGGCG -> GCTCTCGGCGG
TGCTGCCTTAG -> GCTGCCTTAGT
TGCTTAAATCA -> GCTTAAATCAC
TGCTTGTAGTA -> GCTTGTAGTAC
TGGAGCCCATG -> GGAGCCCATGC
TGGAGGAGGCA -> GGAGGAGGCAC
TGGAGTGTTCC -> GGAGTGTTCCC
TGGATAAGAAT -> GGATAAGAATG
TGGCACCCTAG -> GGCACCCTAGA
TGGCCAGAGCC -> GGCCAGAGCCG
TGGCCCATCGC -> GGCCCATCGCC
TGGCGGGGTCT -> GGCGGGGTCTT
TGGCTGAGTGT -> GGCTGAGTGTG
TGGCTGTTTCT -> GGCTGTTTCTG
TGGCTTCAGTC -> GGCTTCAGTCA
TGGGAAGTACA -> GGGAAGTACAG
TGGGAGCCCCT -> GGGAGCCCCTT
TGGGCAGAAGA -> GGGCAGAAGAC
TGGGCGCCCGG -> GGGCGCCCGGG
TGGGCTTCTGG -> GGGCTTCTGGA
TGGGGGCTTCG -> GGGGGCTTCGC
TGGGTAATAAT -> GGGTAATAATC
TGGGTGACGTG -> GGGTGACGTGT
TGGTACGGAAT -> GGTACGGAATT
TGGTATTACCG -> GGTATTACCGG
TGGTCAGATAC -> GGTCAGATACA
TGGTCCGGCAC -> GGTCCGGCACG
TGGTGAGTTGA -> GGTGAGTTGAT
TGGTGCAGGCA -> GGTGCAGGCAT
TGTACAGTGTG -> GTACAGTGTGA
TGTACCTGCAC -> GTACCTGCACA
TGTACGGTTTG -> GTACGGTTTGT
TGTACTAGATA -> GTACTAGATAT
TGTAGATAAAG -> GTAGATAAAGC
TGTAGGTCTAA -> GTAGGTCTAAG
TGTAGTACTAG -> GTAGTACTAGC
TGTAGTTACCT -> GTAGTTACCTT
TGTAGTTCGAA -> GTAGTTCGAAC
TGTATACGTTA -> GTATACGTTAT
TGTATACTTTC -> GTATACTTTCA
TGTATATTCAC -> GTATATTCACG
TGTATGTAGGT -> GTATGTAGGTC
TGTCAGAACAG -> GTCAGAACAGC
TGTCCCTACTA -> GTCCCTACTAG
TGTCCTTAAAA -> GTCCTTAAAAC
TGTCGATGGGC -> GTCGATGGGCA
TGTCGCGGTCC -> GTCGCGGTCCA
TGTCGCTATTC -> GTCGCTATTCC
TGTCTCCTTGA -> GTCTCCTTGAC
TGTGAAGATAA -> GTGAAGATAAT
TGTGACTGATG -> GTGACTGATGT
TGTGAGAGCCG -> GTGAGAGCCGT
TGTGATATCCG -> GTGATATCCGG
TGTGCACCTCA -> GTGCACCTCAA
TGTGCTATGTC -> GTGCTATGTCC
TGTGTATACGT -> GTGTATACGTT
TGTGTCAGAAC -> GTGTCAGAACA
TGTGTGAGAGC -> GTGTGAGAGCC
TGTTATATTCG -> GTTATATTCGG
TGTTCCAACGG -> GTTCCAACGGC
TGTTCCCGGTG -> GTTCCCGGTGC
TGTTCTCCCTG -> GTTCTCCCTGC
TGTTGAGATCC -> GTTGAGATCCA
TGTTGCTGCCT -> GTTGCTGCCTT
TGTTGGAGGAG -> GTTGGAGGAGG
TGTTTCTGGCG -> GTTTCTGGCGG
TTAAAACAATC -> TAAAACAATCT
TTAAAATTGCA -> TAAAATTGCAG
TTAAATCACGA -> TAAATCACGAG
TTAACCATTAG -> TAACCATTAGT
TTAACCCAGAC -> TAACCCAGACT
TTAACGCATGG -> TAACGCATGGT
TTAAGATCCGT -> TAAGATCCGTC
TTAAGTGAAAT -> TAAGTGAAATG
TTAATACAAAC -> TAATACAAACC
TTAATCAGGAA -> TAATCAGGAAG
TTACAAGCCCC -> TACAAGCCCCG
TTACAGAGTGT -> TACAGAGTGTA
TTACCGGTTCG -> TACCGGTTCGT
TTACCTGATCG -> TACCTGATCGC
TTACCTTTGAA -> TACCTTTGAAA
TTACGGAGTCT -> TACGGAGTCTG
TTACGTGCGGG -> TACGTGCGGGC
TTAGAAGCCCG -> TAGAAGCCCGT
TTAGAGGGTGT -> TAGAGGGTGTA
TTAGCCATAGG -> TAGCCATAGGG
TTAGCCTCGCA -> TAGCCTCGCAC
TTAGCCTTATG -> TAGCCTTATGG
TTAGCGATATT -> TAGCGATATTT
TTAGCTTACGT -> TAGCTTACGTG
TTAGGCAATCG -> TAGGCAATCGT
TTAGGTCGTAA -> TAGGTCGTAAT
TTAGTATGACG -> TAGTATGACGA
TTAGTGAGTTT -> TAGTGAGTTTA
TTAGTGCAAAA -> TAGTGCAAAAA
TTAGTGTGTCA -> TAGTGTGTCAG
TTAGTTGGTAT -> TAGTTGGTATT
TTATATTCGGT -> TATATTCGGTC
TTATGAGCTAC -> TATGAGCTACT
TTATGCTCCGA -> TATGCTCCGAA
TTATGGCACCC -> TATGGCACCCT
TTATGGTACGG -> TATGGTACGGA
TTATTATGCTC -> TATTATGCTCC
TTATTGAATAC -> TATTGAATACC
TTATTGCCCTT -> TATTGCCCTTA
TTCAAGTTTCA -> TCAAGTTTCAG
TTCAATACGAT -> TCAATACGATG
TTCACGAACTT -> TCACGAACTTA
TTCAGATGATC -> TCAGATGATCG
TTCAGTCAGCA -> TCAGTCAGCAT
TTCAGTGCTTG -> TCAGTGCTTGT
TTCAGTTAGTT -> TCAGTTAGTTG
TTCATACGTCG -> TCATACGTCGT
TTCATCTATCA -> TCATCTATCAG
TTCATGACAGC -> TCATGACAGCA
TTCCAACGGCT -> TCCAACGGCTT
TTCCATAATGA -> TCCATAATGAC
TTCCCCGAGTT -> TCCCCGAGTTA
TTCCCGGTGCT -> TCCCGGTGCTT
TTCCGCCCCGG -> TCCGCCCCGGA
TTCCGGGCTCG -> TCCGGGCTCGT
TTCCTAGTAAA -> TCCTAGTAAAG
TTCCTTGTTAT -> TCCTTGTTATA
TTCGAAAGGGT -> TCGAAAGGGTA
TTCGAACTTAT -> TCGAACTTATT
TTCGACTCTGT -> TCGACTCTGTT
TTCGAGATGCG -> TCGAGATGCGT
TTCGCCGAACC -> TCGCCGAACCA
TTCGCTATTCA -> TCGCTATTCAA
TTCGGCTCCTC -> TCGGCTCCTCA
TTCGGTCTACA -> TCGGTCTACAG
TTCGTAGACCT -> TCGTAGACCTC
TTCGTCCGACT -> TCGTCCGACTT
TTCGTCGTGGT -> TCGTCGTGGTC
TTCGTTCGGCT -> TCGTTCGGCTC
TTCTACGTTGA -> TCTACGTTGAT
TTCTCCCTGCA -> TCTCCCTGCAA
TTCTGGATAAG -> TCTGGATAAGA
TTCTGGCGGGG -> TCTGGCGGGGT
TTGAAACGCAA -> TGAAACGCAAA
TTGAACTCTAG -> TGAACTCTAGC
TTGAAGAACGG -> TGAAGAACGGT
TTGAAGGGTTA -> TGAAGGGTTAA
TTGAATACCGT -> TGAATACCGTG
TTGACAGGCTC -> TGACAGGCTCT
TTGACCCTGGA -> TGACCCTGGAG
TTGAGATCCAA -> TGAGATCCAAT
TTGATGATAAA -> TGATGATAAAT
TTGATGATTCG -> TGATGATTCGT
TTGATGTGACT -> TGATGTGACTG
TTGATTTAGCC -> TGATTTAGCCT
TTGATTTTTAA -> TGATTTTTAAT
TTGCAGGATGA -> TGCAGGATGAA
TTGCCCGGACT -> TGCCCGGACTT
TTGCCCTTACA -> TGCCCTTACAA
TTGCCTGCAAG -> TGCCTGCAAGT
TTGCTGCCTTA -> TGCTGCCTTAG
TTGGAGGAGGC -> TGGAGGAGGCA
TTGGCTGTTTC -> TGGCTGTTTCT
TTGGGTAATAA -> TGGGTAATAAT
TTGGTATTACC -> TGGTATTACCG
TTGTACGGTTT -> TGTACGGTTTG
TTGTACTAGAT -> TGTACTAGATA
TTGTAGTACTA -> TGTAGTACTAG
TTGTAGTTACC -> TGTAGTTACCT
TTGTCGCGGTC -> TGTCGCGGTCC
TTGTCGCTATT -> TGTCGCTATTC
TTGTGTATACG -> TGTGTATACGT
TTGTTATATTC -> TGTTATATTCG
TTGTTCCAACG -> TGTTCCAACGG
TTTAAGATCCG -> TTAAGATCCGT
TTTAATCAGGA -> TTAATCAGGAA
TTTACAGAGTG -> TTACAGAGTGT
TTTAGAGGGTG -> TTAGAGGGTGT
TTTAGCCTTAT -> TTAGCCTTATG
TTTAGCTTACG -> TTAGCTTACGT
TTTAGGTCGTA -> TTAGGTCGTAA
TTTAGTGCAAA -> TTAGTGCAAAA
TTTCAGATGAT -> TTCAGATGATC
TTTCAGTTAGT -> TTCAGTTAGTT
TTTCATACGTC -> TTCATACGTCG
TTTCATGACAG -> TTCATGACAGC
TTTCTGGCGGG -> TTCTGGCGGGG
TTTGAAACGCA -> TTGAAACGCAA
TTTGAAGAACG -> TTGAAGAACGG
TTTGCCCGGAC -> TTGCCCGGACT
TTTGTAGTTAC -> TTGTAGTTACC
TTTGTCGCTAT -> TTGTCGCTATT
TTTTAATCAGG -> TTTAATCAGGA
TTTTACAGAGT -> TTTACAGAGTG
TTTTAGCTTAC -> TTTAGCTTACG
TTTTTAATCAG -> TTTTAATCAGG
