AAAAAATAACATGGGTATT -> AAAAATAACATGGGTATTC
AAAAACTAAGGGGGGTCCC -> AAAACTAAGGGGGGTCCCG
AAAAATAACATGGGTATTC -> AAAATAACATGGGTATTCT
AAAACCCCCGGCATTCTGG -> AAACCCCCGGCATTCTGGG
AAAACTAAGGGGGGTCCCG -> AAACTAAGGGGGGTCCCGC
AAAAGAGGGGAACATGAAA -> AAAGAGGGGAACATGAAAC
AAAATAACATGGGTATTCT -> AAATAACATGGGTATTCTA
AAACACCTAGGCTGAATAG -> AACACCTAGGCTGAATAGA
AAACCATTACATCACAGAG -> AACCATTACATCACAGAGG
AAACCATTAGCCCAGGTGA -> AACCATTAGCCCAGGTGAC
AAACCCCCGGCATTCTGGG -> AACCCCCGGCATTCTGGGG
AAACGAATTCATAGCGGTC -> AACGAATTCATAGCGGTCA
AAACTAAGGGGGGTCCCGC -> AACTAAGGGGGGTCCCGCC
AAACTTCGTCCCGAGTAGG -> AACTTCGTCCCGAGTAGGC
AAAGAGGGGAACATGAAAC -> AAGAGGGGAACATGAAACG
AAAGCCGAATCATAGGTCT -> AAGCCGAATCATAGGTCTC
AAAGCGCGAAATGGTAGTT -> AAGCGCGAAATGGTAGTTC
AAAGCGCGTTACAACGTCC -> AAGCGCGTTACAACGTCCA
AAAGCGGGCTGCTGTCTTA -> AAGCGGGCTGCTGTCTTAG
AAAGGTGCGCCAGTAACCG -> AAGGTGCGCCAGTAACCGA
AAATAACATGGGTATTCTA -> AATAACATGGGTATTCTAG
AAATCCACATTTAGTCCTG -> AATCCACATTTAGTCCTGC
AAATCGAGTATTCTTACTC -> AATCGAGTATTCTTACTCA
AAATCGTGAGGCGCCTCGG -> AATCGTGAGGCGCCTCGGG
AAATGGTAGTTCAAATTAG -> AATGGTAGTTCAAATTAGT
AAATGTTCAAAGCGCGAAA -> AATGTTCAAAGCGCGAAAT
AAATTAGTGACAAAGCGCG -> AATTAGTGACAAAGCGCGT
AACAAAGCCGAATCATAGG -> ACAAAGCCGAATCATAGGT
AACAATGTATATCACTACG -> ACAATGTATATCACTACGA
AACACACCCCAAAACCCCC -> ACACACCCCAAAACCCCCG
AACACCTAGGCTGAATAGA -> ACACCTAGGCTGAATAGAA
AACACGTTGCCTGATCTCG -> ACACGTTGCCTGATCTCGC
AACAGCACCAACACACCCC -> ACAGCACCAACACACCCCA
AACATCCCTAGCTTCTAGC -> ACATCCCTAGCTTCTAGCA
AACATGAAACGAATTCATA -> ACATGAAACGAATTCATAG
AACATGGGTATTCTAGACA -> ACATGGGTATTCTAGACAT
AACATGTCGATGTGGGGTG -> ACATGTCGATGTGGGGTGT
AACCACGGTATACCTTGTT -> ACCACGGTATACCTTGTTA
AACCATCGAAGGTCGCAGC -> ACCATCGAAGGTCGCAGCT
AACCATTACATCACAGAGG -> ACCATTACATCACAGAGGT
AACCATTAGCCCAGGTGAC -> ACCATTAGCCCAGGTGACT
AACCCAGTCTGCACTGTCG -> ACCCAGTCTGCACTGTCGA
AACCCATAGGGCGGCAGCT -> ACCCATAGGGCGGCAGCTG
AACCCCCGGCATTCTGGGG -> ACCCCCGGCATTCTGGGGA
AACCCGTTAATGGATCACC -> ACCCGTTAATGGATCACCA
AACCCTAAATGTTCAAAGC -> ACCCTAAATGTTCAAAGCG
AACCGATGGCTTTAGATTC -> ACCGATGGCTTTAGATTCC
AACCTCAGAATCCCTAGAC -> ACCTCAGAATCCCTAGACA,ACCTCAGAATCCCTAGACC,ACCTCAGAATCCCTAGACG,ACCTCAGAATCCCTAGACT
AACGAATTCATAGCGGTCA -> ACGAATTCATAGCGGTCAA
AACGACCTAACTCCAATCT -> ACGACCTAACTCCAATCTG
AACGGTAATCCACTTGCCG -> ACGGTAATCCACTTGCCGT
AACGTCCAGCCGACTTCCA -> ACGTCCAGCCGACTTCCAA
AACGTCTGAGTAGGTCCTT -> ACGTCTGAGTAGGTCCTTG
AACGTTGATAGTCCACGTT -> ACGTTGATAGTCCACGTTC
AACTAAGGGGGGTCCCGCC -> ACTAAGGGGGGTCCCGCCT
AACTCCAATCTGAAGAAGG -> ACTCCAATCTGAAGAAGGT
AACTCCGGGACACTTGTGT -> ACTCCGGGACACTTGTGTA
AACTGCCGATCAGTGGCGA -> ACTGCCGATCAGTGGCGAG
AACTGGCTATCAAAAACTA -> ACTGGCTATCAAAAACTAA
AACTTCGTCCCGAGTAGGC -> ACTTCGTCCCGAGTAGGCA
AACTTCTTCTAATTAGTTG -> ACTTCTTCTAATTAGTTGT
AAGAAATCGTGAGGCGCCT -> AGAAATCGTGAGGCGCCTC
AAGAACATGTCGATGTGGG -> AGAACATGTCGATGTGGGG
AAGAAGGTTTCATTGGAGT -> AGAAGGTTTCATTGGAGTC
AAGAATACCCTACGGTGGG -> AGAATACCCTACGGTGGGA
AAGACTCACTCCGGGACAC -> AGACTCACTCCGGGACACT
AAGAGGGGAACATGAAACG -> AGAGGGGAACATGAAACGA
AAGATACGCGGCAACCACG -> AGATACGCGGCAACCACGG
AAGATTTCCATAACCCAGT -> AGATTTCCATAACCCAGTC
AAGCCACCGGGTCCTGTTT -> AGCCACCGGGTCCTGTTTA
AAGCCGAATCATAGGTCTC -> AGCCGAATCATAGGTCTCA
AAGCCGTACATGGTAGTGT -> AGCCGTACATGGTAGTGTG
AAGCCTACAGCCTTATCCC -> AGCCTACAGCCTTATCCCG
AAGCGCGAAATGGTAGTTC -> AGCGCGAAATGGTAGTTCA
AAGCGCGTTACAACGTCCA -> AGCGCGTTACAACGTCCAG
AAGCGGGCTGCTGTCTTAG -> AGCGGGCTGCTGTCTTAGA
AAGGAAGAAATCGTGAGGC -> AGGAAGAAATCGTGAGGCG
AAGGAGTCAACTGCCGATC -> AGGAGTCAACTGCCGATCA
AAGGGAGGCATAGTCGCGG -> AGGGAGGCATAGTCGCGGA
AAGGGGACTTCCGCGCAGA -> AGGGGACTTCCGCGCAGAA
AAGGGGGGTCCCGCCTTTT -> AGGGGGGTCCCGCCTTTTA
AAGGTCGCAGCTGCGTGTT -> AGGTCGCAGCTGCGTGTTG
AAGGTGCGCCAGTAACCGA -> AGGTGCGCCAGTAACCGAT
AAGGTTTCATTGGAGTCAA -> AGGTTTCATTGGAGTCAAG
AAGTCAGACAATGTGGCCC -> AGTCAGACAATGTGGCCCG
AAGTCGAAGTGAAACACCT -> AGTCGAAGTGAAACACCTA
AAGTGAAACACCTAGGCTG -> AGTGAAACACCTAGGCTGA
AAGTTTAGGTGTAGACTGT -> AGTTTAGGTGTAGACTGTC
AATAACATGGGTATTCTAG -> ATAACATGGGTATTCTAGA
AATACACTCCTCCAGTAGA -> ATACACTCCTCCAGTAGAA
AATACCCTACGGTGGGAGG -> ATACCCTACGGTGGGAGGG
AATACTTTTGTCGAGCGAA -> ATACTTTTGTCGAGCGAAA
AATAGAAGATTTCCATAAC -> ATAGAAGATTTCCATAACC
AATAGTCCCTTCTAAGCCT -> ATAGTCCCTTCTAAGCCTA
AATCAAACCATTACATCAC -> ATCAAACCATTACATCACA
AATCATAACAGCACCAACA -> ATCATAACAGCACCAACAC
AATCATAGGTCTCATCATT -> ATCATAGGTCTCATCATTT
AATCATCGGCGACAACCAT -> ATCATCGGCGACAACCATC
AATCCACATTTAGTCCTGC -> ATCCACATTTAGTCCTGCA
AATCCACTTGCCGTACCGA -> ATCCACTTGCCGTACCGAT
AATCCCTAGACAAGGGAGG -> ATCCCTAGACAAGGGAGGC
AATCCCTAGACCGTTAACG -> ATCCCTAGACCGTTAACGG
AATCCCTAGACGGCCCGTG -> ATCCCTAGACGGCCCGTGT
AATCCCTAGACTTTAGCAT -> ATCCCTAGACTTTAGCATA
AATCGAGTATTCTTACTCA -> ATCGAGTATTCTTACTCAG
AATCGTGAGGCGCCTCGGG -> ATCGTGAGGCGCCTCGGGA
AATCGTTAATTCTAATGGA -> ATCGTTAATTCTAATGGAC
AATCTGAAGAAGGTTTCAT -> ATCTGAAGAAGGTTTCATT
AATCTGCTACTAAGACTCA -> ATCTGCTACTAAGACTCAC
AATGATCCAAAGCGGGCTG -> ATGATCCAAAGCGGGCTGC
AATGATCCGCAGGAGCCTG -> ATGATCCGCAGGAGCCTGC
AATGCAGGAATCATAACAG -> ATGCAGGAATCATAACAGC
AATGCGGCCTAAATCCACA -> ATGCGGCCTAAATCCACAT
AATGCTCTTTGTCAGGTGG -> ATGCTCTTTGTCAGGTGGC
AATGGACCTAGGGAGGGTG -> ATGGACCTAGGGAGGGTGC
AATGGATCACCAGAATGAT -> ATGGATCACCAGAATGATC
AATGGTAGTTCAAATTAGT -> ATGGTAGTTCAAATTAGTG
AATGGTGTTACGTCGCCCT -> ATGGTGTTACGTCGCCCTG
AATGTATATCACTACGAGA -> ATGTATATCACTACGAGAC
AATGTATGACTCACAAGGA -> ATGTATGACTCACAAGGAA
AATGTCTAATCTGCTACTA -> ATGTCTAATCTGCTACTAA
AATGTGGCCCGGATAGGGA -> ATGTGGCCCGGATAGGGAC
AATGTGTCTCTCCTAATAC -> ATGTGTCTCTCCTAATACA
AATGTTCAAAGCGCGAAAT -> ATGTTCAAAGCGCGAAATG
AATGTTCTAACAATGTATA -> ATGTTCTAACAATGTATAT
AATTAGTGACAAAGCGCGT -> ATTAGTGACAAAGCGCGTT
AATTAGTTGTAGTTCAGAA -> ATTAGTTGTAGTTCAGAAT
AATTCATAGCGGTCAACAC -> ATTCATAGCGGTCAACACG
AATTCCACCCGTCATGGTC -> ATTCCACCCGTCATGGTCG
AATTCTAATGGACCTAGGG -> ATTCTAATGGACCTAGGGA
AATTGTCCGTCAGGCGAGG -> ATTGTCCGTCAGGCGAGGC
AATTTGTTTTTGGTGTAGT -> ATTTGTTTTTGGTGTAGTA
ACAAAGCCGAATCATAGGT -> CAAAGCCGAATCATAGGTC
ACAAAGCGCGTTACAACGT -> CAAAGCGCGTTACAACGTC
ACAACCATCGAAGGTCGCA -> CAACCATCGAAGGTCGCAG
ACAACGTCCAGCCGACTTC -> CAACGTCCAGCCGACTTCC
ACAAGGAAGAAATCGTGAG -> CAAGGAAGAAATCGTGAGG
ACAAGGGAGGCATAGTCGC -> CAAGGGAGGCATAGTCGCG
ACAATGTATATCACTACGA -> CAATGTATATCACTACGAG
ACAATGTGGCCCGGATAGG -> CAATGTGGCCCGGATAGGG
ACACACCCCAAAACCCCCG -> CACACCCCAAAACCCCCGG
ACACCCCAAAACCCCCGGC -> CACCCCAAAACCCCCGGCA
ACACCTAGGCTGAATAGAA -> CACCTAGGCTGAATAGAAG
ACACGATAAAGGTGCGCCA -> CACGATAAAGGTGCGCCAG
ACACGTTGCCTGATCTCGC -> CACGTTGCCTGATCTCGCG
ACACTCCTCCAGTAGAAAC -> CACTCCTCCAGTAGAAACT
ACACTTGTGTAGCTCGTAG -> CACTTGTGTAGCTCGTAGA
ACACTTGTGTCACGCACGT -> CACTTGTGTCACGCACGTC
ACACTTGTGTGTAGTGGGT -> CACTTGTGTGTAGTGGGTT
ACACTTGTGTTCCCGGCGG -> CACTTGTGTTCCCGGCGGG
ACAGAGGTTTGGTACTCCT -> CAGAGGTTTGGTACTCCTT
ACAGCACCAACACACCCCA -> CAGCACCAACACACCCCAA
ACAGCCTTATCCCGGACCT -> CAGCCTTATCCCGGACCTT
ACATACCGGCAGCAGTATT -> CATACCGGCAGCAGTATTT
ACATACCTCCGTTAGGACG -> CATACCTCCGTTAGGACGG
ACATCACAGAGGTTTGGTA -> CATCACAGAGGTTTGGTAC
ACATCCCTAGCTTCTAGCA -> CATCCCTAGCTTCTAGCAA
ACATGAAACGAATTCATAG -> CATGAAACGAATTCATAGC
ACATGGGTATTCTAGACAT -> CATGGGTATTCTAGACATA
ACATGGTAGTGTGCAATGT -> CATGGTAGTGTGCAATGTC
ACATGTCGATGTGGGGTGT -> CATGTCGATGTGGGGTGTG
ACATGTTCGCAACCCATAG -> CATGTTCGCAACCCATAGG
ACATTAACATCCCTAGCTT -> CATTAACATCCCTAGCTTC
ACATTCTTATAATAGTCCC -> CATTCTTATAATAGTCCCT
ACATTTAGTCCTGCAGCCT -> CATTTAGTCCTGCAGCCTG
ACCAACACACCCCAAAACC -> CCAACACACCCCAAAACCC
ACCACGGTATACCTTGTTA -> CCACGGTATACCTTGTTAT
ACCAGAATGATCCGCAGGA -> CCAGAATGATCCGCAGGAG
ACCATCGAAGGTCGCAGCT -> CCATCGAAGGTCGCAGCTG
ACCATTACATCACAGAGGT -> CCATTACATCACAGAGGTT
ACCATTAGCCCAGGTGACT -> CCATTAGCCCAGGTGACTA
ACCCAGTCTGCACTGTCGA -> CCCAGTCTGCACTGTCGAA
ACCCATAGGGCGGCAGCTG -> CCCATAGGGCGGCAGCTGC
ACCCCAAAACCCCCGGCAT -> CCCCAAAACCCCCGGCATT
ACCCCCGGCATTCTGGGGA -> CCCCCGGCATTCTGGGGAA
ACCCGAACCCTAAATGTTC -> CCCGAACCCTAAATGTTCA
ACCCGCTCCCTCTTAGTGG -> CCCGCTCCCTCTTAGTGGG
ACCCGTCATGGTCGCCCCA -> CCCGTCATGGTCGCCCCAT
ACCCGTTAATGGATCACCA -> CCCGTTAATGGATCACCAG
ACCCTAAATGTTCAAAGCG -> CCCTAAATGTTCAAAGCGC
ACCCTACGGTGGGAGGGGG -> CCCTACGGTGGGAGGGGGG
ACCGATCCGCTTTTGATAC -> CCGATCCGCTTTTGATACA
ACCGATGGCTTTAGATTCC -> CCGATGGCTTTAGATTCCC
ACCGCTTGAATCAAACCAT -> CCGCTTGAATCAAACCATT
ACCGGCAGCAGTATTTACT -> CCGGCAGCAGTATTTACTG
ACCGGGTCCTGTTTAACGT -> CCGGGTCCTGTTTAACGTC
ACCGTTAACGGTAATCCAC -> CCGTTAACGGTAATCCACT
ACCTAACTCCAATCTGAAG -> CCTAACTCCAATCTGAAGA
ACCTAGGCTGAATAGAAGA -> CCTAGGCTGAATAGAAGAT
ACCTAGGGAGGGTGCCGAA -> CCTAGGGAGGGTGCCGAAT
ACCTCAGAATCCCTAGACA -> CCTCAGAATCCCTAGACAA
ACCTCAGAATCCCTAGACC -> CCTCAGAATCCCTAGACCG
ACCTCAGAATCCCTAGACG -> CCTCAGAATCCCTAGACGG
ACCTCAGAATCCCTAGACT -> CCTCAGAATCCCTAGACTT
ACCTCCGTTAGGACGGGTC -> CCTCCGTTAGGACGGGTCG
ACCTTGCGTTTGAATGTAT -> CCTTGCGTTTGAATGTATG
ACCTTGTTATAGGGGCCCC -> CCTTGTTATAGGGGCCCCC
ACGAATTCATAGCGGTCAA -> CGAATTCATAGCGGTCAAC
ACGACCTAACTCCAATCTG -> CGACCTAACTCCAATCTGA
ACGAGACCGCTTGAATCAA -> CGAGACCGCTTGAATCAAA
ACGAGACTGGTACGAGACC -> CGAGACTGGTACGAGACCG
ACGATAAAGGTGCGCCAGT -> CGATAAAGGTGCGCCAGTA
ACGCACGTCGAACCTCAGA -> CGCACGTCGAACCTCAGAA
ACGCAGGATCTTGGGAAGC -> CGCAGGATCTTGGGAAGCC
ACGCGGCAACCACGGTATA -> CGCGGCAACCACGGTATAC
ACGCTGGAGGGCAAGATAC -> CGCTGGAGGGCAAGATACG
ACGGACGCTGGAGGGCAAG -> CGGACGCTGGAGGGCAAGA
ACGGAGATAGTCGGGTCGC -> CGGAGATAGTCGGGTCGCT
ACGGAGTATTTTCACTTTT -> CGGAGTATTTTCACTTTTT
ACGGCCCGTGTGCTTGTCG -> CGGCCCGTGTGCTTGTCGG
ACGGGTCGCGTTTAGATCT -> CGGGTCGCGTTTAGATCTG
ACGGTAATCCACTTGCCGT -> CGGTAATCCACTTGCCGTA
ACGGTATACCTTGTTATAG -> CGGTATACCTTGTTATAGG
ACGGTGGGAGGGGGGATAA -> CGGTGGGAGGGGGGATAAT
ACGTCCAGCCGACTTCCAA -> CGTCCAGCCGACTTCCAAC
ACGTCGAACCTCAGAATCC -> CGTCGAACCTCAGAATCCC
ACGTCGCCCTGCACCCGCT -> CGTCGCCCTGCACCCGCTC
ACGTCTGAGTAGGTCCTTG -> CGTCTGAGTAGGTCCTTGC
ACGTTCCTATGCAGACCCG -> CGTTCCTATGCAGACCCGA
ACGTTCTCTCTGGGCCTAC -> CGTTCTCTCTGGGCCTACG
ACGTTGATAGTCCACGTTC -> CGTTGATAGTCCACGTTCT
ACGTTGCCTGATCTCGCGA -> CGTTGCCTGATCTCGCGAT
ACTAAGAACATGTCGATGT -> CTAAGAACATGTCGATGTG
ACTAAGACTCACTCCGGGA -> CTAAGACTCACTCCGGGAC
ACTAAGGGGGGTCCCGCCT -> CTAAGGGGGGTCCCGCCTT
ACTACGAGACTGGTACGAG -> CTACGAGACTGGTACGAGA
ACTAGGTCGTTAGCAGATC -> CTAGGTCGTTAGCAGATCG
ACTATGTAAGGGGACTTCC -> CTATGTAAGGGGACTTCCG
ACTCACAAGGAAGAAATCG -> CTCACAAGGAAGAAATCGT
ACTCACTCCGGGACACTTG -> CTCACTCCGGGACACTTGT
ACTCAGGATGTTGCAGAAT -> CTCAGGATGTTGCAGAATG
ACTCCAATCTGAAGAAGGT -> CTCCAATCTGAAGAAGGTT
ACTCCGGGACACTTGTGTA -> CTCCGGGACACTTGTGTAG
ACTCCGGGACACTTGTGTC -> CTCCGGGACACTTGTGTCA
ACTCCGGGACACTTGTGTG -> CTCCGGGACACTTGTGTGT
ACTCCGGGACACTTGTGTT -> CTCCGGGACACTTGTGTTC
ACTCCTCCAGTAGAAACTT -> CTCCTCCAGTAGAAACTTC
ACTCCTTGCGGATCCGGTC -> CTCCTTGCGGATCCGGTCA
ACTCGTCGTTATCCCCTAA -> CTCGTCGTTATCCCCTAAT
ACTGAATACTTTTGTCGAG -> CTGAATACTTTTGTCGAGC
ACTGATGATCTGTTATAGG -> CTGATGATCTGTTATAGGA
ACTGCCGATCAGTGGCGAG -> CTGCCGATCAGTGGCGAGT
ACTGGCTATCAAAAACTAA -> CTGGCTATCAAAAACTAAG
ACTGGTACGAGACCGCTTG -> CTGGTACGAGACCGCTTGA
ACTGTCGAATTTGTTTTTG -> CTGTCGAATTTGTTTTTGG
ACTGTCTGTCTAGAGTCAT -> CTGTCTGTCTAGAGTCATG
ACTGTTATCTTGGTGTAGG -> CTGTTATCTTGGTGTAGGC
ACTTCCAACAAAGCCGAAT -> CTTCCAACAAAGCCGAATC
ACTTCCGCGCAGAATGCGG -> CTTCCGCGCAGAATGCGGC
ACTTCGTCCCGAGTAGGCA -> CTTCGTCCCGAGTAGGCAG
ACTTCTTCTAATTAGTTGT -> CTTCTTCTAATTAGTTGTA
ACTTGCCGTACCGATCCGC -> CTTGCCGTACCGATCCGCT
ACTTGTGTAGCTCGTAGAT -> CTTGTGTAGCTCGTAGATA
ACTTGTGTCACGCACGTCG -> CTTGTGTCACGCACGTCGA
ACTTGTGTGTAGTGGGTTC -> CTTGTGTGTAGTGGGTTCA
ACTTGTGTTCCCGGCGGGC -> CTTGTGTTCCCGGCGGGCA
ACTTTAGCATACATTAACA -> CTTTAGCATACATTAACAT
ACTTTTGTCGAGCGAAACC -> CTTTTGTCGAGCGAAACCA
ACTTTTTACTATGTAAGGG -> CTTTTTACTATGTAAGGGG
AGAAACTTCGTCCCGAGTA -> GAAACTTCGTCCCGAGTAG
AGAAATCGTGAGGCGCCTC -> GAAATCGTGAGGCGCCTCG
AGAACATGTCGATGTGGGG -> GAACATGTCGATGTGGGGT
AGAAGATTTCCATAACCCA -> GAAGATTTCCATAACCCAG
AGAAGGAGTCAACTGCCGA -> GAAGGAGTCAACTGCCGAT
AGAAGGTTTCATTGGAGTC -> GAAGGTTTCATTGGAGTCA
AGAATACCCTACGGTGGGA -> GAATACCCTACGGTGGGAG
AGAATCATCGGCGACAACC -> GAATCATCGGCGACAACCA
AGAATCCCTAGACAAGGGA -> GAATCCCTAGACAAGGGAG
AGAATCCCTAGACCGTTAA -> GAATCCCTAGACCGTTAAC
AGAATCCCTAGACGGCCCG -> GAATCCCTAGACGGCCCGT
AGAATCCCTAGACTTTAGC -> GAATCCCTAGACTTTAGCA
AGAATGATCCAAAGCGGGC -> GAATGATCCAAAGCGGGCT
AGAATGATCCGCAGGAGCC -> GAATGATCCGCAGGAGCCT
AGAATGCGGCCTAAATCCA -> GAATGCGGCCTAAATCCAC
AGAATGGTGTTACGTCGCC -> GAATGGTGTTACGTCGCCC
AGACAAGGGAGGCATAGTC -> GACAAGGGAGGCATAGTCG
AGACAATGTGGCCCGGATA -> GACAATGTGGCCCGGATAG
AGACATACCTCCGTTAGGA -> GACATACCTCCGTTAGGAC
AGACCCGAACCCTAAATGT -> GACCCGAACCCTAAATGTT
AGACCGCTTGAATCAAACC -> GACCGCTTGAATCAAACCA
AGACCGTTAACGGTAATCC -> GACCGTTAACGGTAATCCA
AGACGGCCCGTGTGCTTGT -> GACGGCCCGTGTGCTTGTC
AGACTCACTCCGGGACACT -> GACTCACTCCGGGACACTT
AGACTCCGGGACACTTGTG -> GACTCCGGGACACTTGTGT
AGACTCGTCGTTATCCCCT -> GACTCGTCGTTATCCCCTA
AGACTGGTACGAGACCGCT -> GACTGGTACGAGACCGCTT
AGACTGTCTGTCTAGAGTC -> GACTGTCTGTCTAGAGTCA
AGACTTTAGCATACATTAA -> GACTTTAGCATACATTAAC
AGAGATAGCGAGAATCATC -> GAGATAGCGAGAATCATCG
AGAGGATAGTCCTAAAAGA -> GAGGATAGTCCTAAAAGAG
AGAGGGGAACATGAAACGA -> GAGGGGAACATGAAACGAA
AGAGGTTTGGTACTCCTTG -> GAGGTTTGGTACTCCTTGC
AGAGTCATGGTACTCCGGG -> GAGTCATGGTACTCCGGGA
AGATAACCTCAGAATCCCT -> GATAACCTCAGAATCCCTA
AGATACGCGGCAACCACGG -> GATACGCGGCAACCACGGT
AGATAGCGAGAATCATCGG -> GATAGCGAGAATCATCGGC
AGATAGTCGGGTCGCTAGT -> GATAGTCGGGTCGCTAGTA
AGATCGACACGATAAAGGT -> GATCGACACGATAAAGGTG
AGATCTGGTTGATATCCGA -> GATCTGGTTGATATCCGAG
AGATTCCCACGTTCCTATG -> GATTCCCACGTTCCTATGC
AGATTTCCATAACCCAGTC -> GATTTCCATAACCCAGTCT
AGCAATCGTTAATTCTAAT -> GCAATCGTTAATTCTAATG
AGCACCAACACACCCCAAA -> GCACCAACACACCCCAAAA
AGCAGATCGACACGATAAA -> GCAGATCGACACGATAAAG
AGCAGTATTTACTGATGAT -> GCAGTATTTACTGATGATC
AGCAGTTCTCAAGTCGAAG -> GCAGTTCTCAAGTCGAAGT
AGCATACATTAACATCCCT -> GCATACATTAACATCCCTA
AGCATTTGGACTGAATACT -> GCATTTGGACTGAATACTT
AGCCACCGGGTCCTGTTTA -> GCCACCGGGTCCTGTTTAA
AGCCCAGGTGACTAGGTCG -> GCCCAGGTGACTAGGTCGT
AGCCGAATCATAGGTCTCA -> GCCGAATCATAGGTCTCAT
AGCCGACTTCCAACAAAGC -> GCCGACTTCCAACAAAGCC
AGCCGTACATGGTAGTGTG -> GCCGTACATGGTAGTGTGC
AGCCTACAGCCTTATCCCG -> GCCTACAGCCTTATCCCGG
AGCCTGCGTGGGCACATTC -> GCCTGCGTGGGCACATTCT
AGCCTGTAATTCCACCCGT -> GCCTGTAATTCCACCCGTC
AGCCTTAAGTCAGACAATG -> GCCTTAAGTCAGACAATGT
AGCCTTATCCCGGACCTTG -> GCCTTATCCCGGACCTTGC
AGCCTTCTAGAAGGAGTCA -> GCCTTCTAGAAGGAGTCAA
AGCGAAACCATTAGCCCAG -> GCGAAACCATTAGCCCAGG
AGCGAGAATCATCGGCGAC -> GCGAGAATCATCGGCGACA
AGCGCGAAATGGTAGTTCA -> GCGCGAAATGGTAGTTCAA
AGCGCGTTACAACGTCCAG -> GCGCGTTACAACGTCCAGC
AGCGGGCTGCTGTCTTAGA -> GCGGGCTGCTGTCTTAGAG
AGCGGTCAACACGTTGCCT -> GCGGTCAACACGTTGCCTG
AGCTCCATGAATGTTCTAA -> GCTCCATGAATGTTCTAAC
AGCTCCTAAGAATACCCTA -> GCTCCTAAGAATACCCTAC
AGCTCGTAGATAACCTCAG -> GCTCGTAGATAACCTCAGA
AGCTGCGTGTTGCAACGTT -> GCTGCGTGTTGCAACGTTG
AGCTGCTTGGCATCCTAAC -> GCTGCTTGGCATCCTAACT
AGCTTCTAGCAATCGTTAA -> GCTTCTAGCAATCGTTAAT
AGGAAGAAATCGTGAGGCG -> GGAAGAAATCGTGAGGCGC
AGGAAGTTTAGGTGTAGAC -> GGAAGTTTAGGTGTAGACT
AGGAATCATAACAGCACCA -> GGAATCATAACAGCACCAA
AGGACGGGTCGCGTTTAGA -> GGACGGGTCGCGTTTAGAT
AGGAGCCTGCGTGGGCACA -> GGAGCCTGCGTGGGCACAT
AGGAGTCAACTGCCGATCA -> GGAGTCAACTGCCGATCAG
AGGATAGTCCTAAAAGAGG -> GGATAGTCCTAAAAGAGGG
AGGATCCACTAAGAACATG -> GGATCCACTAAGAACATGT
AGGATCTTGGGAAGCCGTA -> GGATCTTGGGAAGCCGTAC
AGGATGTTGCAGAATGATC -> GGATGTTGCAGAATGATCC
AGGCAGAGGATAGTCCTAA -> GGCAGAGGATAGTCCTAAA
AGGCATAGTCGCGGAGCCT -> GGCATAGTCGCGGAGCCTT
AGGCCCCGTCTATGAGCAT -> GGCCCCGTCTATGAGCATT
AGGCCGGGATTTTCCCATG -> GGCCGGGATTTTCCCATGG
AGGCGAGGCCCCGTCTATG -> GGCGAGGCCCCGTCTATGA
AGGCGCCTCGGGAGACTCC -> GGCGCCTCGGGAGACTCCG
AGGCTGAATAGAAGATTTC -> GGCTGAATAGAAGATTTCC
AGGGACGGAGTATTTTCAC -> GGGACGGAGTATTTTCACT
AGGGAGGCATAGTCGCGGA -> GGGAGGCATAGTCGCGGAG
AGGGAGGGTGCCGAATGCT -> GGGAGGGTGCCGAATGCTC
AGGGCAAGATACGCGGCAA -> GGGCAAGATACGCGGCAAC
AGGGCCACTGTTATCTTGG -> GGGCCACTGTTATCTTGGT
AGGGCGGCAGCTGCTTGGC -> GGGCGGCAGCTGCTTGGCA
AGGGGAACATGAAACGAAT -> GGGGAACATGAAACGAATT
AGGGGACTTCCGCGCAGAA -> GGGGACTTCCGCGCAGAAT
AGGGGCCCCCGAGGATCCA -> GGGGCCCCCGAGGATCCAC
AGGGGGGATAATGCAGGAA -> GGGGGGATAATGCAGGAAT
AGGGGGGTCCCGCCTTTTA -> GGGGGGTCCCGCCTTTTAC
AGGGTGCCGAATGCTCTTT -> GGGTGCCGAATGCTCTTTG
AGGTCCTTGCAGCTCCTAA -> GGTCCTTGCAGCTCCTAAG
AGGTCGCAGCTGCGTGTTG -> GGTCGCAGCTGCGTGTTGC
AGGTCGGCTTCGTACATAC -> GGTCGGCTTCGTACATACC
AGGTCGTTAGCAGATCGAC -> GGTCGTTAGCAGATCGACA
AGGTCTCATCATTTAGACT -> GGTCTCATCATTTAGACTC
AGGTGACTAGGTCGTTAGC -> GGTGACTAGGTCGTTAGCA
AGGTGCGCCAGTAACCGAT -> GGTGCGCCAGTAACCGATG
AGGTGGCAGGGCCACTGTT -> GGTGGCAGGGCCACTGTTA
AGGTGTAGACTGTCTGTCT -> GGTGTAGACTGTCTGTCTA
AGGTTTCATTGGAGTCAAG -> GGTTTCATTGGAGTCAAGC
AGGTTTGGTACTCCTTGCG -> GGTTTGGTACTCCTTGCGG
AGTAACCGATGGCTTTAGA -> GTAACCGATGGCTTTAGAT
AGTACGGACGCTGGAGGGC -> GTACGGACGCTGGAGGGCA
AGTAGAAACTTCGTCCCGA -> GTAGAAACTTCGTCCCGAG
AGTAGCCTTAAGTCAGACA -> GTAGCCTTAAGTCAGACAA
AGTAGGCAGAGGATAGTCC -> GTAGGCAGAGGATAGTCCT
AGTAGGTCCTTGCAGCTCC -> GTAGGTCCTTGCAGCTCCT
AGTATTCTTACTCAGGATG -> GTATTCTTACTCAGGATGT
AGTATTTACTGATGATCTG -> GTATTTACTGATGATCTGT
AGTATTTTCACTTTTTACT -> GTATTTTCACTTTTTACTA
AGTCAACTGCCGATCAGTG -> GTCAACTGCCGATCAGTGG
AGTCAAGCCACCGGGTCCT -> GTCAAGCCACCGGGTCCTG
AGTCAGACAATGTGGCCCG -> GTCAGACAATGTGGCCCGG
AGTCATGGTACTCCGGGAC -> GTCATGGTACTCCGGGACA
AGTCCACGTTCTCTCTGGG -> GTCCACGTTCTCTCTGGGC
AGTCCCTTCTAAGCCTACA -> GTCCCTTCTAAGCCTACAG
AGTCCTAAAAGAGGGGAAC -> GTCCTAAAAGAGGGGAACA
AGTCCTGCAGCCTGTAATT -> GTCCTGCAGCCTGTAATTC
AGTCGAAGTGAAACACCTA -> GTCGAAGTGAAACACCTAG
AGTCGCGGAGCCTTCTAGA -> GTCGCGGAGCCTTCTAGAA
AGTCGGGTCGCTAGTAGCC -> GTCGGGTCGCTAGTAGCCT
AGTCTGCACTGTCGAATTT -> GTCTGCACTGTCGAATTTG
AGTGAAACACCTAGGCTGA -> GTGAAACACCTAGGCTGAA
AGTGACAAAGCGCGTTACA -> GTGACAAAGCGCGTTACAA
AGTGGCGAGTGTGTCAACG -> GTGGCGAGTGTGTCAACGA
AGTGGGATCCGTGATTAAC -> GTGGGATCCGTGATTAACT
AGTGGGTTCAACCTCAGAA -> GTGGGTTCAACCTCAGAAT
AGTGTGCAATGTCTAATCT -> GTGTGCAATGTCTAATCTG
AGTGTGTCAACGACCTAAC -> GTGTGTCAACGACCTAACT
AGTTCAAATTAGTGACAAA -> GTTCAAATTAGTGACAAAG
AGTTCAGAATGGTGTTACG -> GTTCAGAATGGTGTTACGT
AGTTCTCAAGTCGAAGTGA -> GTTCTCAAGTCGAAGTGAA
AGTTGTAGTTCAGAATGGT -> GTTGTAGTTCAGAATGGTG
AGTTTAGGTGTAGACTGTC -> GTTTAGGTGTAGACTGTCT
ATAAAAAATAACATGGGTA -> TAAAAAATAACATGGGTAT
ATAAAGGTGCGCCAGTAAC -> TAAAGGTGCGCCAGTAACC
ATAACAGCACCAACACACC -> TAACAGCACCAACACACCC
ATAACATGGGTATTCTAGA -> TAACATGGGTATTCTAGAC
ATAACCCAGTCTGCACTGT -> TAACCCAGTCTGCACTGTC
ATAACCTCAGAATCCCTAG -> TAACCTCAGAATCCCTAGA
ATAATAGTCCCTTCTAAGC -> TAATAGTCCCTTCTAAGCC
ATAATGCAGGAATCATAAC -> TAATGCAGGAATCATAACA
ATACACTCCTCCAGTAGAA -> TACACTCCTCCAGTAGAAA
ATACATGTTCGCAACCCAT -> TACATGTTCGCAACCCATA
ATACATTAACATCCCTAGC -> TACATTAACATCCCTAGCT
ATACCCTACGGTGGGAGGG -> TACCCTACGGTGGGAGGGG
ATACCGGCAGCAGTATTTA -> TACCGGCAGCAGTATTTAC
ATACCTCCGTTAGGACGGG -> TACCTCCGTTAGGACGGGT
ATACCTTGTTATAGGGGCC -> TACCTTGTTATAGGGGCCC
ATACGCGGCAACCACGGTA -> TACGCGGCAACCACGGTAT
ATACTTTTGTCGAGCGAAA -> TACTTTTGTCGAGCGAAAC
ATAGAAGATTTCCATAACC -> TAGAAGATTTCCATAACCC
ATAGCGAGAATCATCGGCG -> TAGCGAGAATCATCGGCGA
ATAGCGGTCAACACGTTGC -> TAGCGGTCAACACGTTGCC
ATAGGAAGTTTAGGTGTAG -> TAGGAAGTTTAGGTGTAGA
ATAGGGACGGAGTATTTTC -> TAGGGACGGAGTATTTTCA
ATAGGGCGGCAGCTGCTTG -> TAGGGCGGCAGCTGCTTGG
ATAGGGGCCCCCGAGGATC -> TAGGGGCCCCCGAGGATCC
ATAGGTCTCATCATTTAGA -> TAGGTCTCATCATTTAGAC
ATAGTCCACGTTCTCTCTG -> TAGTCCACGTTCTCTCTGG
ATAGTCCCTTCTAAGCCTA -> TAGTCCCTTCTAAGCCTAC
ATAGTCCTAAAAGAGGGGA -> TAGTCCTAAAAGAGGGGAA
ATAGTCGCGGAGCCTTCTA -> TAGTCGCGGAGCCTTCTAG
ATAGTCGGGTCGCTAGTAG -> TAGTCGGGTCGCTAGTAGC
ATATAAAAAATAACATGGG -> TATAAAAAATAACATGGGT
ATATCACTACGAGACTGGT -> TATCACTACGAGACTGGTA
ATATCCGAGCAGTTCTCAA -> TATCCGAGCAGTTCTCAAG
ATCAAAAACTAAGGGGGGT -> TCAAAAACTAAGGGGGGTC
ATCAAACCATTACATCACA -> TCAAACCATTACATCACAG
ATCACAGAGGTTTGGTACT -> TCACAGAGGTTTGGTACTC
ATCACCAGAATGATCCGCA -> TCACCAGAATGATCCGCAG
ATCACTACGAGACTGGTAC -> TCACTACGAGACTGGTACG
ATCAGTGGCGAGTGTGTCA -> TCAGTGGCGAGTGTGTCAA
ATCATAACAGCACCAACAC -> TCATAACAGCACCAACACA
ATCATAGGTCTCATCATTT -> TCATAGGTCTCATCATTTA
ATCATCGGCGACAACCATC -> TCATCGGCGACAACCATCG
ATCATTTAGACTCGTCGTT -> TCATTTAGACTCGTCGTTA
ATCCAAAGCGGGCTGCTGT -> TCCAAAGCGGGCTGCTGTC
ATCCACATTTAGTCCTGCA -> TCCACATTTAGTCCTGCAG
ATCCACTAAGAACATGTCG -> TCCACTAAGAACATGTCGA
ATCCACTTGCCGTACCGAT -> TCCACTTGCCGTACCGATC
ATCCCCTAATGTGTCTCTC -> TCCCCTAATGTGTCTCTCC
ATCCCGGACCTTGCGTTTG -> TCCCGGACCTTGCGTTTGA
ATCCCTAGACAAGGGAGGC -> TCCCTAGACAAGGGAGGCA
ATCCCTAGACCGTTAACGG -> TCCCTAGACCGTTAACGGT
ATCCCTAGACGGCCCGTGT -> TCCCTAGACGGCCCGTGTG
ATCCCTAGACTTTAGCATA -> TCCCTAGACTTTAGCATAC
ATCCCTAGCTTCTAGCAAT -> TCCCTAGCTTCTAGCAATC
ATCCGAGCAGTTCTCAAGT -> TCCGAGCAGTTCTCAAGTC
ATCCGCAGGAGCCTGCGTG -> TCCGCAGGAGCCTGCGTGG
ATCCGCTTTTGATACATGT -> TCCGCTTTTGATACATGTT
ATCCGGTCATCGTGATATA -> TCCGGTCATCGTGATATAA
ATCCGTGATTAACTCCGGG -> TCCGTGATTAACTCCGGGA
ATCCTAACTTCTTCTAATT -> TCCTAACTTCTTCTAATTA
ATCGAAGGTCGCAGCTGCG -> TCGAAGGTCGCAGCTGCGT
ATCGACACGATAAAGGTGC -> TCGACACGATAAAGGTGCG
ATCGAGTATTCTTACTCAG -> TCGAGTATTCTTACTCAGG
ATCGATGTGCGGGGTGTTG -> TCGATGTGCGGGGTGTTGT
ATCGCAGCTCCATGAATGT -> TCGCAGCTCCATGAATGTT
ATCGGCGACAACCATCGAA -> TCGGCGACAACCATCGAAG
ATCGTGAGGCGCCTCGGGA -> TCGTGAGGCGCCTCGGGAG
ATCGTGATATAAAAAATAA -> TCGTGATATAAAAAATAAC
ATCGTTAATTCTAATGGAC -> TCGTTAATTCTAATGGACC
ATCTCGCGATCGATGTGCG -> TCTCGCGATCGATGTGCGG
ATCTGAAGAAGGTTTCATT -> TCTGAAGAAGGTTTCATTG
ATCTGCTACTAAGACTCAC -> TCTGCTACTAAGACTCACT
ATCTGGTTGATATCCGAGC -> TCTGGTTGATATCCGAGCA
ATCTGTTATAGGAAGTTTA -> TCTGTTATAGGAAGTTTAG
ATCTTGGGAAGCCGTACAT -> TCTTGGGAAGCCGTACATG
ATCTTGGTGTAGGCCGGGA -> TCTTGGTGTAGGCCGGGAT
ATGAAACGAATTCATAGCG -> TGAAACGAATTCATAGCGG
ATGAATGTTCTAACAATGT -> TGAATGTTCTAACAATGTA
ATGACTCACAAGGAAGAAA -> TGACTCACAAGGAAGAAAT
ATGAGCATTTGGACTGAAT -> TGAGCATTTGGACTGAATA
ATGATCCAAAGCGGGCTGC -> TGATCCAAAGCGGGCTGCT
ATGATCCGCAGGAGCCTGC -> TGATCCGCAGGAGCCTGCG
ATGATCTGTTATAGGAAGT -> TGATCTGTTATAGGAAGTT
ATGCAGACCCGAACCCTAA -> TGCAGACCCGAACCCTAAA
ATGCAGGAATCATAACAGC -> TGCAGGAATCATAACAGCA
ATGCGGCCTAAATCCACAT -> TGCGGCCTAAATCCACATT
ATGCTCTTTGTCAGGTGGC -> TGCTCTTTGTCAGGTGGCA
ATGGACCTAGGGAGGGTGC -> TGGACCTAGGGAGGGTGCC
ATGGATCACCAGAATGATC -> TGGATCACCAGAATGATCC
ATGGCCGCCGGTGCTAATT -> TGGCCGCCGGTGCTAATTG
ATGGCTTTAGATTCCCACG -> TGGCTTTAGATTCCCACGT
ATGGGTATTCTAGACATAC -> TGGGTATTCTAGACATACC
ATGGTACTCCGGGACACTT -> TGGTACTCCGGGACACTTG
ATGGTAGTGTGCAATGTCT -> TGGTAGTGTGCAATGTCTA
ATGGTAGTTCAAATTAGTG -> TGGTAGTTCAAATTAGTGA
ATGGTCGCCCCATTATCGC -> TGGTCGCCCCATTATCGCA
ATGGTGTTACGTCGCCCTG -> TGGTGTTACGTCGCCCTGC
ATGTAAGGGGACTTCCGCG -> TGTAAGGGGACTTCCGCGC
ATGTATATCACTACGAGAC -> TGTATATCACTACGAGACT
ATGTATGACTCACAAGGAA -> TGTATGACTCACAAGGAAG
ATGTCGATGTGGGGTGTGA -> TGTCGATGTGGGGTGTGAT
ATGTCTAATCTGCTACTAA -> TGTCTAATCTGCTACTAAG
ATGTGCGGGGTGTTGTCTG -> TGTGCGGGGTGTTGTCTGA
ATGTGGCCCGGATAGGGAC -> TGTGGCCCGGATAGGGACG
ATGTGGGGTGTGATTAACC -> TGTGGGGTGTGATTAACCC
ATGTGTCTCTCCTAATACA -> TGTGTCTCTCCTAATACAC
ATGTTCAAAGCGCGAAATG -> TGTTCAAAGCGCGAAATGG
ATGTTCGCAACCCATAGGG -> TGTTCGCAACCCATAGGGC
ATGTTCTAACAATGTATAT -> TGTTCTAACAATGTATATC
ATGTTGCAGAATGATCCAA -> TGTTGCAGAATGATCCAAA
ATTAACATCCCTAGCTTCT -> TTAACATCCCTAGCTTCTA
ATTAACCCGTTAATGGATC -> TTAACCCGTTAATGGATCA
ATTAACTCCGGGACACTTG -> TTAACTCCGGGACACTTGT
ATTACATCACAGAGGTTTG -> TTACATCACAGAGGTTTGG
ATTAGCCCAGGTGACTAGG -> TTAGCCCAGGTGACTAGGT
ATTAGTGACAAAGCGCGTT -> TTAGTGACAAAGCGCGTTA
ATTAGTTGTAGTTCAGAAT -> TTAGTTGTAGTTCAGAATG
ATTATCGCAGCTCCATGAA -> TTATCGCAGCTCCATGAAT
ATTCATAGCGGTCAACACG -> TTCATAGCGGTCAACACGT
ATTCCACCCGTCATGGTCG -> TTCCACCCGTCATGGTCGC
ATTCCCACGTTCCTATGCA -> TTCCCACGTTCCTATGCAG
ATTCTAATGGACCTAGGGA -> TTCTAATGGACCTAGGGAG
ATTCTAGACATACCTCCGT -> TTCTAGACATACCTCCGTT
ATTCTGGGGAACTGGCTAT -> TTCTGGGGAACTGGCTATC
ATTCTTACTCAGGATGTTG -> TTCTTACTCAGGATGTTGC
ATTCTTATAATAGTCCCTT -> TTCTTATAATAGTCCCTTC
ATTGGAGTCAAGCCACCGG -> TTGGAGTCAAGCCACCGGG
ATTGTCCGTCAGGCGAGGC -> TTGTCCGTCAGGCGAGGCC
ATTTACTGATGATCTGTTA -> TTTACTGATGATCTGTTAT
ATTTAGACTCGTCGTTATC -> TTTAGACTCGTCGTTATCC
ATTTAGTCCTGCAGCCTGT -> TTTAGTCCTGCAGCCTGTA
ATTTCCATAACCCAGTCTG -> TTTCCATAACCCAGTCTGC
ATTTGGACTGAATACTTTT -> TTTGGACTGAATACTTTTG
ATTTGTTTTTGGTGTAGTA -> TTTGTTTTTGGTGTAGTAC
ATTTTCACTTTTTACTATG -> TTTTCACTTTTTACTATGT
ATTTTCCCATGGCCGCCGG -> TTTTCCCATGGCCGCCGGT
CAAAAACTAAGGGGGGTCC -> AAAAACTAAGGGGGGTCCC
CAAAACCCCCGGCATTCTG -> AAAACCCCCGGCATTCTGG
CAAACCATTACATCACAGA -> AAACCATTACATCACAGAG
CAAAGCCGAATCATAGGTC -> AAAGCCGAATCATAGGTCT
CAAAGCGCGAAATGGTAGT -> AAAGCGCGAAATGGTAGTT
CAAAGCGCGTTACAACGTC -> AAAGCGCGTTACAACGTCC
CAAAGCGGGCTGCTGTCTT -> AAAGCGGGCTGCTGTCTTA
CAAATTAGTGACAAAGCGC -> AAATTAGTGACAAAGCGCG
CAACAAAGCCGAATCATAG -> AACAAAGCCGAATCATAGG
CAACACACCCCAAAACCCC -> AACACACCCCAAAACCCCC
CAACACGTTGCCTGATCTC -> AACACGTTGCCTGATCTCG
CAACCACGGTATACCTTGT -> AACCACGGTATACCTTGTT
CAACCATCGAAGGTCGCAG -> AACCATCGAAGGTCGCAGC
CAACCCATAGGGCGGCAGC -> AACCCATAGGGCGGCAGCT
CAACCTCAGAATCCCTAGA -> AACCTCAGAATCCCTAGAC,AACCTCAGAATCCCTAGAC
CAACGACCTAACTCCAATC -> AACGACCTAACTCCAATCT
CAACGTCCAGCCGACTTCC -> AACGTCCAGCCGACTTCCA
CAACGTTGATAGTCCACGT -> AACGTTGATAGTCCACGTT
CAACTGCCGATCAGTGGCG -> AACTGCCGATCAGTGGCGA
CAAGATACGCGGCAACCAC -> AAGATACGCGGCAACCACG
CAAGCCACCGGGTCCTGTT -> AAGCCACCGGGTCCTGTTT
CAAGGAAGAAATCGTGAGG -> AAGGAAGAAATCGTGAGGC
CAAGGGAGGCATAGTCGCG -> AAGGGAGGCATAGTCGCGG
CAAGTCGAAGTGAAACACC -> AAGTCGAAGTGAAACACCT
CAATCGTTAATTCTAATGG -> AATCGTTAATTCTAATGGA
CAATCTGAAGAAGGTTTCA -> AATCTGAAGAAGGTTTCAT
CAATGTATATCACTACGAG -> AATGTATATCACTACGAGA
CAATGTCTAATCTGCTACT -> AATGTCTAATCTGCTACTA
CAATGTGGCCCGGATAGGG -> AATGTGGCCCGGATAGGGA
CACAAGGAAGAAATCGTGA -> ACAAGGAAGAAATCGTGAG
CACACCCCAAAACCCCCGG -> ACACCCCAAAACCCCCGGC
CACAGAGGTTTGGTACTCC -> ACAGAGGTTTGGTACTCCT
CACATTCTTATAATAGTCC -> ACATTCTTATAATAGTCCC
CACATTTAGTCCTGCAGCC -> ACATTTAGTCCTGCAGCCT
CACCAACACACCCCAAAAC -> ACCAACACACCCCAAAACC
CACCAGAATGATCCGCAGG -> ACCAGAATGATCCGCAGGA
CACCCCAAAACCCCCGGCA -> ACCCCAAAACCCCCGGCAT
CACCCGCTCCCTCTTAGTG -> ACCCGCTCCCTCTTAGTGG
CACCCGTCATGGTCGCCCC -> ACCCGTCATGGTCGCCCCA
CACCGGGTCCTGTTTAACG -> ACCGGGTCCTGTTTAACGT
CACCTAGGCTGAATAGAAG -> ACCTAGGCTGAATAGAAGA
CACGATAAAGGTGCGCCAG -> ACGATAAAGGTGCGCCAGT
CACGCACGTCGAACCTCAG -> ACGCACGTCGAACCTCAGA
CACGGTATACCTTGTTATA -> ACGGTATACCTTGTTATAG
CACGTCGAACCTCAGAATC -> ACGTCGAACCTCAGAATCC
CACGTTCCTATGCAGACCC -> ACGTTCCTATGCAGACCCG
CACGTTCTCTCTGGGCCTA -> ACGTTCTCTCTGGGCCTAC
CACGTTGCCTGATCTCGCG -> ACGTTGCCTGATCTCGCGA
CACTAAGAACATGTCGATG -> ACTAAGAACATGTCGATGT
CACTACGAGACTGGTACGA -> ACTACGAGACTGGTACGAG
CACTCCGGGACACTTGTGT -> ACTCCGGGACACTTGTGTC
CACTCCTCCAGTAGAAACT -> ACTCCTCCAGTAGAAACTT
CACTGTCGAATTTGTTTTT -> ACTGTCGAATTTGTTTTTG
CACTGTTATCTTGGTGTAG -> ACTGTTATCTTGGTGTAGG
CACTTGCCGTACCGATCCG -> ACTTGCCGTACCGATCCGC
CACTTGTGTAGCTCGTAGA -> ACTTGTGTAGCTCGTAGAT
CACTTGTGTCACGCACGTC -> ACTTGTGTCACGCACGTCG
CACTTGTGTGTAGTGGGTT -> ACTTGTGTGTAGTGGGTTC
CACTTGTGTTCCCGGCGGG -> ACTTGTGTTCCCGGCGGGC
CACTTTTTACTATGTAAGG -> ACTTTTTACTATGTAAGGG
CAGAATCCCTAGACAAGGG -> AGAATCCCTAGACAAGGGA
CAGAATCCCTAGACCGTTA -> AGAATCCCTAGACCGTTAA
CAGAATCCCTAGACGGCCC -> AGAATCCCTAGACGGCCCG
CAGAATCCCTAGACTTTAG -> AGAATCCCTAGACTTTAGC
CAGAATGATCCAAAGCGGG -> AGAATGATCCAAAGCGGGC
CAGAATGATCCGCAGGAGC -> AGAATGATCCGCAGGAGCC
CAGAATGCGGCCTAAATCC -> AGAATGCGGCCTAAATCCA
CAGAATGGTGTTACGTCGC -> AGAATGGTGTTACGTCGCC
CAGACAATGTGGCCCGGAT -> AGACAATGTGGCCCGGATA
CAGACCCGAACCCTAAATG -> AGACCCGAACCCTAAATGT
CAGAGGATAGTCCTAAAAG -> AGAGGATAGTCCTAAAAGA
CAGAGGTTTGGTACTCCTT -> AGAGGTTTGGTACTCCTTG
CAGATCGACACGATAAAGG -> AGATCGACACGATAAAGGT
CAGCACCAACACACCCCAA -> AGCACCAACACACCCCAAA
CAGCAGTATTTACTGATGA -> AGCAGTATTTACTGATGAT
CAGCCGACTTCCAACAAAG -> AGCCGACTTCCAACAAAGC
CAGCCTGTAATTCCACCCG -> AGCCTGTAATTCCACCCGT
CAGCCTTATCCCGGACCTT -> AGCCTTATCCCGGACCTTG
CAGCTCCATGAATGTTCTA -> AGCTCCATGAATGTTCTAA
CAGCTCCTAAGAATACCCT -> AGCTCCTAAGAATACCCTA
CAGCTGCGTGTTGCAACGT -> AGCTGCGTGTTGCAACGTT
CAGCTGCTTGGCATCCTAA -> AGCTGCTTGGCATCCTAAC
CAGGAATCATAACAGCACC -> AGGAATCATAACAGCACCA
CAGGAGCCTGCGTGGGCAC -> AGGAGCCTGCGTGGGCACA
CAGGATCTTGGGAAGCCGT -> AGGATCTTGGGAAGCCGTA
CAGGATGTTGCAGAATGAT -> AGGATGTTGCAGAATGATC
CAGGCGAGGCCCCGTCTAT -> AGGCGAGGCCCCGTCTATG
CAGGGCCACTGTTATCTTG -> AGGGCCACTGTTATCTTGG
CAGGTGACTAGGTCGTTAG -> AGGTGACTAGGTCGTTAGC
CAGGTGGCAGGGCCACTGT -> AGGTGGCAGGGCCACTGTT
CAGTAACCGATGGCTTTAG -> AGTAACCGATGGCTTTAGA
CAGTAGAAACTTCGTCCCG -> AGTAGAAACTTCGTCCCGA
CAGTATTTACTGATGATCT -> AGTATTTACTGATGATCTG
CAGTCTGCACTGTCGAATT -> AGTCTGCACTGTCGAATTT
CAGTGGCGAGTGTGTCAAC -> AGTGGCGAGTGTGTCAACG
CAGTTCTCAAGTCGAAGTG -> AGTTCTCAAGTCGAAGTGA
CATAACAGCACCAACACAC -> ATAACAGCACCAACACACC
CATAACCCAGTCTGCACTG -> ATAACCCAGTCTGCACTGT
CATACATTAACATCCCTAG -> ATACATTAACATCCCTAGC
CATACCGGCAGCAGTATTT -> ATACCGGCAGCAGTATTTA
CATACCTCCGTTAGGACGG -> ATACCTCCGTTAGGACGGG
CATAGCGGTCAACACGTTG -> ATAGCGGTCAACACGTTGC
CATAGGGCGGCAGCTGCTT -> ATAGGGCGGCAGCTGCTTG
CATAGGTCTCATCATTTAG -> ATAGGTCTCATCATTTAGA
CATAGTCGCGGAGCCTTCT -> ATAGTCGCGGAGCCTTCTA
CATCACAGAGGTTTGGTAC -> ATCACAGAGGTTTGGTACT
CATCATTTAGACTCGTCGT -> ATCATTTAGACTCGTCGTT
CATCCCTAGCTTCTAGCAA -> ATCCCTAGCTTCTAGCAAT
CATCCTAACTTCTTCTAAT -> ATCCTAACTTCTTCTAATT
CATCGAAGGTCGCAGCTGC -> ATCGAAGGTCGCAGCTGCG
CATCGGCGACAACCATCGA -> ATCGGCGACAACCATCGAA
CATCGTGATATAAAAAATA -> ATCGTGATATAAAAAATAA
CATGAAACGAATTCATAGC -> ATGAAACGAATTCATAGCG
CATGAATGTTCTAACAATG -> ATGAATGTTCTAACAATGT
CATGGCCGCCGGTGCTAAT -> ATGGCCGCCGGTGCTAATT
CATGGGTATTCTAGACATA -> ATGGGTATTCTAGACATAC
CATGGTACTCCGGGACACT -> ATGGTACTCCGGGACACTT
CATGGTAGTGTGCAATGTC -> ATGGTAGTGTGCAATGTCT
CATGGTCGCCCCATTATCG -> ATGGTCGCCCCATTATCGC
CATGTCGATGTGGGGTGTG -> ATGTCGATGTGGGGTGTGA
CATGTTCGCAACCCATAGG -> ATGTTCGCAACCCATAGGG
CATTAACATCCCTAGCTTC -> ATTAACATCCCTAGCTTCT
CATTACATCACAGAGGTTT -> ATTACATCACAGAGGTTTG
CATTAGCCCAGGTGACTAG -> ATTAGCCCAGGTGACTAGG
CATTATCGCAGCTCCATGA -> ATTATCGCAGCTCCATGAA
CATTCTGGGGAACTGGCTA -> ATTCTGGGGAACTGGCTAT
CATTCTTATAATAGTCCCT -> ATTCTTATAATAGTCCCTT
CATTGGAGTCAAGCCACCG -> ATTGGAGTCAAGCCACCGG
CATTTAGACTCGTCGTTAT -> ATTTAGACTCGTCGTTATC
CATTTAGTCCTGCAGCCTG -> ATTTAGTCCTGCAGCCTGT
CATTTGGACTGAATACTTT -> ATTTGGACTGAATACTTTT
CCAAAACCCCCGGCATTCT -> CAAAACCCCCGGCATTCTG
CCAAAGCGGGCTGCTGTCT -> CAAAGCGGGCTGCTGTCTT
CCAACAAAGCCGAATCATA -> CAACAAAGCCGAATCATAG
CCAACACACCCCAAAACCC -> CAACACACCCCAAAACCCC
CCAATCTGAAGAAGGTTTC -> CAATCTGAAGAAGGTTTCA
CCACATTTAGTCCTGCAGC -> CACATTTAGTCCTGCAGCC
CCACCCGTCATGGTCGCCC -> CACCCGTCATGGTCGCCCC
CCACCGGGTCCTGTTTAAC -> CACCGGGTCCTGTTTAACG
CCACGGTATACCTTGTTAT -> CACGGTATACCTTGTTATA
CCACGTTCCTATGCAGACC -> CACGTTCCTATGCAGACCC
CCACGTTCTCTCTGGGCCT -> CACGTTCTCTCTGGGCCTA
CCACTAAGAACATGTCGAT -> CACTAAGAACATGTCGATG
CCACTGTTATCTTGGTGTA -> CACTGTTATCTTGGTGTAG
CCACTTGCCGTACCGATCC -> CACTTGCCGTACCGATCCG
CCAGAATGATCCGCAGGAG -> CAGAATGATCCGCAGGAGC
CCAGCCGACTTCCAACAAA -> CAGCCGACTTCCAACAAAG
CCAGGTGACTAGGTCGTTA -> CAGGTGACTAGGTCGTTAG
CCAGTAACCGATGGCTTTA -> CAGTAACCGATGGCTTTAG
CCAGTAGAAACTTCGTCCC -> CAGTAGAAACTTCGTCCCG
CCAGTCTGCACTGTCGAAT -> CAGTCTGCACTGTCGAATT
CCATAACCCAGTCTGCACT -> CATAACCCAGTCTGCACTG
CCATAGGGCGGCAGCTGCT -> CATAGGGCGGCAGCTGCTT
CCATCGAAGGTCGCAGCTG -> CATCGAAGGTCGCAGCTGC
CCATGAATGTTCTAACAAT -> CATGAATGTTCTAACAATG
CCATGGCCGCCGGTGCTAA -> CATGGCCGCCGGTGCTAAT
CCATTACATCACAGAGGTT -> CATTACATCACAGAGGTTT
CCATTAGCCCAGGTGACTA -> CATTAGCCCAGGTGACTAG
CCATTATCGCAGCTCCATG -> CATTATCGCAGCTCCATGA
CCCAAAACCCCCGGCATTC -> CCAAAACCCCCGGCATTCT
CCCACGTTCCTATGCAGAC -> CCACGTTCCTATGCAGACC
CCCAGGTGACTAGGTCGTT -> CCAGGTGACTAGGTCGTTA
CCCAGTCTGCACTGTCGAA -> CCAGTCTGCACTGTCGAAT
CCCATAGGGCGGCAGCTGC -> CCATAGGGCGGCAGCTGCT
CCCATGGCCGCCGGTGCTA -> CCATGGCCGCCGGTGCTAA
CCCATTATCGCAGCTCCAT -> CCATTATCGCAGCTCCATG
CCCCAAAACCCCCGGCATT -> CCCAAAACCCCCGGCATTC
CCCCATTATCGCAGCTCCA -> CCCATTATCGCAGCTCCAT
CCCCCGAGGATCCACTAAG -> CCCCGAGGATCCACTAAGA
CCCCCGGCATTCTGGGGAA -> CCCCGGCATTCTGGGGAAC
CCCCGAGGATCCACTAAGA -> CCCGAGGATCCACTAAGAA
CCCCGGCATTCTGGGGAAC -> CCCGGCATTCTGGGGAACT
CCCCGTCTATGAGCATTTG -> CCCGTCTATGAGCATTTGG
CCCCTAATGTGTCTCTCCT -> CCCTAATGTGTCTCTCCTA
CCCGAACCCTAAATGTTCA -> CCGAACCCTAAATGTTCAA
CCCGAGGATCCACTAAGAA -> CCGAGGATCCACTAAGAAC
CCCGAGTAGGCAGAGGATA -> CCGAGTAGGCAGAGGATAG
CCCGCCTTTTACAGTCTGC -> CCGCCTTTTACAGTCTGCA
CCCGCTCCCTCTTAGTGGG -> CCGCTCCCTCTTAGTGGGA
CCCGGACCTTGCGTTTGAA -> CCGGACCTTGCGTTTGAAT
CCCGGATAGGGACGGAGTA -> CCGGATAGGGACGGAGTAT
CCCGGCATTCTGGGGAACT -> CCGGCATTCTGGGGAACTG
CCCGGCGGGCAACCTCAGA -> CCGGCGGGCAACCTCAGAA
CCCGTCATGGTCGCCCCAT -> CCGTCATGGTCGCCCCATT
CCCGTCTATGAGCATTTGG -> CCGTCTATGAGCATTTGGA
CCCGTGTGCTTGTCGGAAA -> CCGTGTGCTTGTCGGAAAT
CCCGTTAATGGATCACCAG -> CCGTTAATGGATCACCAGA
CCCTAAATGTTCAAAGCGC -> CCTAAATGTTCAAAGCGCG
CCCTAATGTGTCTCTCCTA -> CCTAATGTGTCTCTCCTAA
CCCTACGGTGGGAGGGGGG -> CCTACGGTGGGAGGGGGGA
CCCTAGACAAGGGAGGCAT -> CCTAGACAAGGGAGGCATA
CCCTAGACCGTTAACGGTA -> CCTAGACCGTTAACGGTAA
CCCTAGACGGCCCGTGTGC -> CCTAGACGGCCCGTGTGCT
CCCTAGACTTTAGCATACA -> CCTAGACTTTAGCATACAT
CCCTAGCTTCTAGCAATCG -> CCTAGCTTCTAGCAATCGT
CCCTCTTAGTGGGATCCGT -> CCTCTTAGTGGGATCCGTG
CCCTGCACCCGCTCCCTCT -> CCTGCACCCGCTCCCTCTT
CCCTTCTAAGCCTACAGCC -> CCTTCTAAGCCTACAGCCT
CCGAACCCTAAATGTTCAA -> CGAACCCTAAATGTTCAAA
CCGAATCATAGGTCTCATC -> CGAATCATAGGTCTCATCA
CCGAATGCTCTTTGTCAGG -> CGAATGCTCTTTGTCAGGT
CCGACTTCCAACAAAGCCG -> CGACTTCCAACAAAGCCGA
CCGAGCAGTTCTCAAGTCG -> CGAGCAGTTCTCAAGTCGA
CCGAGGATCCACTAAGAAC -> CGAGGATCCACTAAGAACA
CCGAGTAGGCAGAGGATAG -> CGAGTAGGCAGAGGATAGT
CCGATCAGTGGCGAGTGTG -> CGATCAGTGGCGAGTGTGT
CCGATCCGCTTTTGATACA -> CGATCCGCTTTTGATACAT
CCGATGGCTTTAGATTCCC -> CGATGGCTTTAGATTCCCA
CCGCAGGAGCCTGCGTGGG -> CGCAGGAGCCTGCGTGGGC
CCGCCGGTGCTAATTGTCC -> CGCCGGTGCTAATTGTCCG
CCGCGCAGAATGCGGCCTA -> CGCGCAGAATGCGGCCTAA
CCGCTCCCTCTTAGTGGGA -> CGCTCCCTCTTAGTGGGAT
CCGCTTGAATCAAACCATT -> CGCTTGAATCAAACCATTA
CCGCTTTTGATACATGTTC -> CGCTTTTGATACATGTTCG
CCGGACCTTGCGTTTGAAT -> CGGACCTTGCGTTTGAATG
CCGGATAGGGACGGAGTAT -> CGGATAGGGACGGAGTATT
CCGGCAGCAGTATTTACTG -> CGGCAGCAGTATTTACTGA
CCGGCATTCTGGGGAACTG -> CGGCATTCTGGGGAACTGG
CCGGCGGGCAACCTCAGAA -> CGGCGGGCAACCTCAGAAT
CCGGGACACTTGTGTAGCT -> CGGGACACTTGTGTAGCTC
CCGGGACACTTGTGTCACG -> CGGGACACTTGTGTCACGC
CCGGGACACTTGTGTGTAG -> CGGGACACTTGTGTGTAGT
CCGGGACACTTGTGTTCCC -> CGGGACACTTGTGTTCCCG
CCGGGATTTTCCCATGGCC -> CGGGATTTTCCCATGGCCG
CCGGGTCCTGTTTAACGTC -> CGGGTCCTGTTTAACGTCT
CCGGTCATCGTGATATAAA -> CGGTCATCGTGATATAAAA
CCGGTGCTAATTGTCCGTC -> CGGTGCTAATTGTCCGTCA
CCGTACATGGTAGTGTGCA -> CGTACATGGTAGTGTGCAA
CCGTACCGATCCGCTTTTG -> CGTACCGATCCGCTTTTGA
CCGTCAGGCGAGGCCCCGT -> CGTCAGGCGAGGCCCCGTC
CCGTCATGGTCGCCCCATT -> CGTCATGGTCGCCCCATTA
CCGTCTATGAGCATTTGGA -> CGTCTATGAGCATTTGGAC
CCGTGATTAACTCCGGGAC -> CGTGATTAACTCCGGGACA
CCGTGTGCTTGTCGGAAAT -> CGTGTGCTTGTCGGAAATC
CCGTTAACGGTAATCCACT -> CGTTAACGGTAATCCACTT
CCGTTAATGGATCACCAGA -> CGTTAATGGATCACCAGAA
CCGTTAGGACGGGTCGCGT -> CGTTAGGACGGGTCGCGTT
CCTAAAAGAGGGGAACATG -> CTAAAAGAGGGGAACATGA
CCTAAATCCACATTTAGTC -> CTAAATCCACATTTAGTCC
CCTAAATGTTCAAAGCGCG -> CTAAATGTTCAAAGCGCGA
CCTAACTCCAATCTGAAGA -> CTAACTCCAATCTGAAGAA
CCTAACTTCTTCTAATTAG -> CTAACTTCTTCTAATTAGT
CCTAAGAATACCCTACGGT -> CTAAGAATACCCTACGGTG
CCTAATACACTCCTCCAGT -> CTAATACACTCCTCCAGTA
CCTAATGTGTCTCTCCTAA -> CTAATGTGTCTCTCCTAAT
CCTACAGCCTTATCCCGGA -> CTACAGCCTTATCCCGGAC
CCTACGCAGGATCTTGGGA -> CTACGCAGGATCTTGGGAA
CCTACGGTGGGAGGGGGGA -> CTACGGTGGGAGGGGGGAT
CCTAGACAAGGGAGGCATA -> CTAGACAAGGGAGGCATAG
CCTAGACCGTTAACGGTAA -> CTAGACCGTTAACGGTAAT
CCTAGACGGCCCGTGTGCT -> CTAGACGGCCCGTGTGCTT
CCTAGACTTTAGCATACAT -> CTAGACTTTAGCATACATT
CCTAGCTTCTAGCAATCGT -> CTAGCTTCTAGCAATCGTT
CCTAGGCTGAATAGAAGAT -> CTAGGCTGAATAGAAGATT
CCTAGGGAGGGTGCCGAAT -> CTAGGGAGGGTGCCGAATG
CCTATGCAGACCCGAACCC -> CTATGCAGACCCGAACCCT
CCTCAGAATCCCTAGACAA -> CTCAGAATCCCTAGACAAG
CCTCAGAATCCCTAGACCG -> CTCAGAATCCCTAGACCGT
CCTCAGAATCCCTAGACGG -> CTCAGAATCCCTAGACGGC
CCTCAGAATCCCTAGACTT -> CTCAGAATCCCTAGACTTT
CCTCCAGTAGAAACTTCGT -> CTCCAGTAGAAACTTCGTC
CCTCCGTTAGGACGGGTCG -> CTCCGTTAGGACGGGTCGC
CCTCGGGAGACTCCGGGAC -> CTCGGGAGACTCCGGGACA
CCTCTTAGTGGGATCCGTG -> CTCTTAGTGGGATCCGTGA
CCTGATCTCGCGATCGATG -> CTGATCTCGCGATCGATGT
CCTGCACCCGCTCCCTCTT -> CTGCACCCGCTCCCTCTTA
CCTGCAGCCTGTAATTCCA -> CTGCAGCCTGTAATTCCAC
CCTGCGTGGGCACATTCTT -> CTGCGTGGGCACATTCTTA
CCTGTAATTCCACCCGTCA -> CTGTAATTCCACCCGTCAT
CCTGTTTAACGTCTGAGTA -> CTGTTTAACGTCTGAGTAG
CCTTAAGTCAGACAATGTG -> CTTAAGTCAGACAATGTGG
CCTTATCCCGGACCTTGCG -> CTTATCCCGGACCTTGCGT
CCTTCTAAGCCTACAGCCT -> CTTCTAAGCCTACAGCCTT
CCTTCTAGAAGGAGTCAAC -> CTTCTAGAAGGAGTCAACT
CCTTGCAGCTCCTAAGAAT -> CTTGCAGCTCCTAAGAATA
CCTTGCGGATCCGGTCATC -> CTTGCGGATCCGGTCATCG
CCTTGCGTTTGAATGTATG -> CTTGCGTTTGAATGTATGA
CCTTGTTATAGGGGCCCCC -> CTTGTTATAGGGGCCCCCG
CGAAACCATTAGCCCAGGT -> GAAACCATTAGCCCAGGTG
CGAAATGGTAGTTCAAATT -> GAAATGGTAGTTCAAATTA
CGAACCCTAAATGTTCAAA -> GAACCCTAAATGTTCAAAG
CGAACCTCAGAATCCCTAG -> GAACCTCAGAATCCCTAGA
CGAAGGTCGCAGCTGCGTG -> GAAGGTCGCAGCTGCGTGT
CGAAGTGAAACACCTAGGC -> GAAGTGAAACACCTAGGCT
CGAATCATAGGTCTCATCA -> GAATCATAGGTCTCATCAT
CGAATGCTCTTTGTCAGGT -> GAATGCTCTTTGTCAGGTG
CGAATTCATAGCGGTCAAC -> GAATTCATAGCGGTCAACA
CGAATTTGTTTTTGGTGTA -> GAATTTGTTTTTGGTGTAG
CGACAACCATCGAAGGTCG -> GACAACCATCGAAGGTCGC
CGACACGATAAAGGTGCGC -> GACACGATAAAGGTGCGCC
CGACCTAACTCCAATCTGA -> GACCTAACTCCAATCTGAA
CGACTTCCAACAAAGCCGA -> GACTTCCAACAAAGCCGAA
CGAGAATCATCGGCGACAA -> GAGAATCATCGGCGACAAC
CGAGACCGCTTGAATCAAA -> GAGACCGCTTGAATCAAAC
CGAGACTGGTACGAGACCG -> GAGACTGGTACGAGACCGC
CGAGCAGTTCTCAAGTCGA -> GAGCAGTTCTCAAGTCGAA
CGAGCGAAACCATTAGCCC -> GAGCGAAACCATTAGCCCA
CGAGGATCCACTAAGAACA -> GAGGATCCACTAAGAACAT
CGAGGCCCCGTCTATGAGC -> GAGGCCCCGTCTATGAGCA
CGAGTAGGCAGAGGATAGT -> GAGTAGGCAGAGGATAGTC
CGAGTATTCTTACTCAGGA -> GAGTATTCTTACTCAGGAT
CGAGTGTGTCAACGACCTA -> GAGTGTGTCAACGACCTAA
CGATAAAGGTGCGCCAGTA -> GATAAAGGTGCGCCAGTAA
CGATCAGTGGCGAGTGTGT -> GATCAGTGGCGAGTGTGTC
CGATCCGCTTTTGATACAT -> GATCCGCTTTTGATACATG
CGATCGATGTGCGGGGTGT -> GATCGATGTGCGGGGTGTT
CGATGGCTTTAGATTCCCA -> GATGGCTTTAGATTCCCAC
CGATGTGCGGGGTGTTGTC -> GATGTGCGGGGTGTTGTCT
CGATGTGGGGTGTGATTAA -> GATGTGGGGTGTGATTAAC
CGCAACCCATAGGGCGGCA -> GCAACCCATAGGGCGGCAG
CGCACGTCGAACCTCAGAA -> GCACGTCGAACCTCAGAAT
CGCAGAATGCGGCCTAAAT -> GCAGAATGCGGCCTAAATC
CGCAGCTCCATGAATGTTC -> GCAGCTCCATGAATGTTCT
CGCAGCTGCGTGTTGCAAC -> GCAGCTGCGTGTTGCAACG
CGCAGGAGCCTGCGTGGGC -> GCAGGAGCCTGCGTGGGCA
CGCAGGATCTTGGGAAGCC -> GCAGGATCTTGGGAAGCCG
CGCCAGTAACCGATGGCTT -> GCCAGTAACCGATGGCTTT
CGCCCCATTATCGCAGCTC -> GCCCCATTATCGCAGCTCC
CGCCCTGCACCCGCTCCCT -> GCCCTGCACCCGCTCCCTC
CGCCGGTGCTAATTGTCCG -> GCCGGTGCTAATTGTCCGT
CGCCTCGGGAGACTCCGGG -> GCCTCGGGAGACTCCGGGA
CGCGAAATGGTAGTTCAAA -> GCGAAATGGTAGTTCAAAT
CGCGATCGATGTGCGGGGT -> GCGATCGATGTGCGGGGTG
CGCGCAGAATGCGGCCTAA -> GCGCAGAATGCGGCCTAAA
CGCGGAGCCTTCTAGAAGG -> GCGGAGCCTTCTAGAAGGA
CGCGGCAACCACGGTATAC -> GCGGCAACCACGGTATACC
CGCGTTACAACGTCCAGCC -> GCGTTACAACGTCCAGCCG
CGCGTTTAGATCTGGTTGA -> GCGTTTAGATCTGGTTGAT
CGCTAGTAGCCTTAAGTCA -> GCTAGTAGCCTTAAGTCAG
CGCTCCCTCTTAGTGGGAT -> GCTCCCTCTTAGTGGGATC
CGCTGGAGGGCAAGATACG -> GCTGGAGGGCAAGATACGC
CGCTTGAATCAAACCATTA -> GCTTGAATCAAACCATTAC
CGCTTTTGATACATGTTCG -> GCTTTTGATACATGTTCGC
CGGAAATCGAGTATTCTTA -> GGAAATCGAGTATTCTTAC
CGGACCTTGCGTTTGAATG -> GGACCTTGCGTTTGAATGT
CGGACGCTGGAGGGCAAGA -> GGACGCTGGAGGGCAAGAT
CGGAGATAGTCGGGTCGCT -> GGAGATAGTCGGGTCGCTA
CGGAGCCTTCTAGAAGGAG -> GGAGCCTTCTAGAAGGAGT
CGGAGTATTTTCACTTTTT -> GGAGTATTTTCACTTTTTA
CGGATAGGGACGGAGTATT -> GGATAGGGACGGAGTATTT
CGGATCCGGTCATCGTGAT -> GGATCCGGTCATCGTGATA
CGGCAACCACGGTATACCT -> GGCAACCACGGTATACCTT
CGGCAGCAGTATTTACTGA -> GGCAGCAGTATTTACTGAT
CGGCAGCTGCTTGGCATCC -> GGCAGCTGCTTGGCATCCT
CGGCATTCTGGGGAACTGG -> GGCATTCTGGGGAACTGGC
CGGCCCGTGTGCTTGTCGG -> GGCCCGTGTGCTTGTCGGA
CGGCCTAAATCCACATTTA -> GGCCTAAATCCACATTTAG
CGGCGACAACCATCGAAGG -> GGCGACAACCATCGAAGGT
CGGCGGGCAACCTCAGAAT -> GGCGGGCAACCTCAGAATC
CGGCTTCGTACATACCGGC -> GGCTTCGTACATACCGGCA
CGGGACACTTGTGTAGCTC -> GGGACACTTGTGTAGCTCG
CGGGACACTTGTGTCACGC -> GGGACACTTGTGTCACGCA
CGGGACACTTGTGTGTAGT -> GGGACACTTGTGTGTAGTG
CGGGACACTTGTGTTCCCG -> GGGACACTTGTGTTCCCGG
CGGGAGACTCCGGGACACT -> GGGAGACTCCGGGACACTT
CGGGATTTTCCCATGGCCG -> GGGATTTTCCCATGGCCGC
CGGGCAACCTCAGAATCCC -> GGGCAACCTCAGAATCCCT
CGGGCTGCTGTCTTAGAGA -> GGGCTGCTGTCTTAGAGAT
CGGGGTGTTGTCTGACGGA -> GGGGTGTTGTCTGACGGAG
CGGGTCCTGTTTAACGTCT -> GGGTCCTGTTTAACGTCTG
CGGGTCGCGTTTAGATCTG -> GGGTCGCGTTTAGATCTGG
CGGGTCGCTAGTAGCCTTA -> GGGTCGCTAGTAGCCTTAA
CGGTAATCCACTTGCCGTA -> GGTAATCCACTTGCCGTAC
CGGTATACCTTGTTATAGG -> GGTATACCTTGTTATAGGG
CGGTCAACACGTTGCCTGA -> GGTCAACACGTTGCCTGAT
CGGTCATCGTGATATAAAA -> GGTCATCGTGATATAAAAA
CGGTGCTAATTGTCCGTCA -> GGTGCTAATTGTCCGTCAG
CGGTGGGAGGGGGGATAAT -> GGTGGGAGGGGGGATAATG
CGTACATACCGGCAGCAGT -> GTACATACCGGCAGCAGTA
CGTACATGGTAGTGTGCAA -> GTACATGGTAGTGTGCAAT
CGTACCGATCCGCTTTTGA -> GTACCGATCCGCTTTTGAT
CGTAGATAACCTCAGAATC -> GTAGATAACCTCAGAATCC
CGTCAGGCGAGGCCCCGTC -> GTCAGGCGAGGCCCCGTCT
CGTCATGGTCGCCCCATTA -> GTCATGGTCGCCCCATTAT
CGTCCAGCCGACTTCCAAC -> GTCCAGCCGACTTCCAACA
CGTCCCGAGTAGGCAGAGG -> GTCCCGAGTAGGCAGAGGA
CGTCGAACCTCAGAATCCC -> GTCGAACCTCAGAATCCCT
CGTCGCCCTGCACCCGCTC -> GTCGCCCTGCACCCGCTCC
CGTCGTTATCCCCTAATGT -> GTCGTTATCCCCTAATGTG
CGTCTATGAGCATTTGGAC -> GTCTATGAGCATTTGGACT
CGTCTGAGTAGGTCCTTGC -> GTCTGAGTAGGTCCTTGCA
CGTGAGGCGCCTCGGGAGA -> GTGAGGCGCCTCGGGAGAC
CGTGATATAAAAAATAACA -> GTGATATAAAAAATAACAT
CGTGATTAACTCCGGGACA -> GTGATTAACTCCGGGACAC
CGTGGGCACATTCTTATAA -> GTGGGCACATTCTTATAAT
CGTGTGCTTGTCGGAAATC -> GTGTGCTTGTCGGAAATCG
CGTGTTGCAACGTTGATAG -> GTGTTGCAACGTTGATAGT
CGTTAACGGTAATCCACTT -> GTTAACGGTAATCCACTTG
CGTTAATGGATCACCAGAA -> GTTAATGGATCACCAGAAT
CGTTAATTCTAATGGACCT -> GTTAATTCTAATGGACCTA
CGTTACAACGTCCAGCCGA -> GTTACAACGTCCAGCCGAC
CGTTAGCAGATCGACACGA -> GTTAGCAGATCGACACGAT
CGTTAGGACGGGTCGCGTT -> GTTAGGACGGGTCGCGTTT
CGTTATCCCCTAATGTGTC -> GTTATCCCCTAATGTGTCT
CGTTCCTATGCAGACCCGA -> GTTCCTATGCAGACCCGAA
CGTTCTCTCTGGGCCTACG -> GTTCTCTCTGGGCCTACGC
CGTTGATAGTCCACGTTCT -> GTTGATAGTCCACGTTCTC
CGTTGCCTGATCTCGCGAT -> GTTGCCTGATCTCGCGATC
CGTTTAGATCTGGTTGATA -> GTTTAGATCTGGTTGATAT
CGTTTGAATGTATGACTCA -> GTTTGAATGTATGACTCAC
CTAAAAGAGGGGAACATGA -> TAAAAGAGGGGAACATGAA
CTAAATCCACATTTAGTCC -> TAAATCCACATTTAGTCCT
CTAAATGTTCAAAGCGCGA -> TAAATGTTCAAAGCGCGAA
CTAACAATGTATATCACTA -> TAACAATGTATATCACTAC
CTAACTCCAATCTGAAGAA -> TAACTCCAATCTGAAGAAG
CTAACTTCTTCTAATTAGT -> TAACTTCTTCTAATTAGTT
CTAAGAACATGTCGATGTG -> TAAGAACATGTCGATGTGG
CTAAGAATACCCTACGGTG -> TAAGAATACCCTACGGTGG
CTAAGACTCACTCCGGGAC -> TAAGACTCACTCCGGGACA
CTAAGCCTACAGCCTTATC -> TAAGCCTACAGCCTTATCC
CTAAGGGGGGTCCCGCCTT -> TAAGGGGGGTCCCGCCTTT
CTAATACACTCCTCCAGTA -> TAATACACTCCTCCAGTAG
CTAATCTGCTACTAAGACT -> TAATCTGCTACTAAGACTC
CTAATGGACCTAGGGAGGG -> TAATGGACCTAGGGAGGGT
CTAATGTGTCTCTCCTAAT -> TAATGTGTCTCTCCTAATA
CTAATTAGTTGTAGTTCAG -> TAATTAGTTGTAGTTCAGA
CTAATTGTCCGTCAGGCGA -> TAATTGTCCGTCAGGCGAG
CTACAGCCTTATCCCGGAC -> TACAGCCTTATCCCGGACC
CTACGAGACTGGTACGAGA -> TACGAGACTGGTACGAGAC
CTACGCAGGATCTTGGGAA -> TACGCAGGATCTTGGGAAG
CTACGGTGGGAGGGGGGAT -> TACGGTGGGAGGGGGGATA
CTACTAAGACTCACTCCGG -> TACTAAGACTCACTCCGGG
CTAGAAGGAGTCAACTGCC -> TAGAAGGAGTCAACTGCCG
CTAGACAAGGGAGGCATAG -> TAGACAAGGGAGGCATAGT
CTAGACATACCTCCGTTAG -> TAGACATACCTCCGTTAGG
CTAGACCGTTAACGGTAAT -> TAGACCGTTAACGGTAATC
CTAGACGGCCCGTGTGCTT -> TAGACGGCCCGTGTGCTTG
CTAGACTTTAGCATACATT -> TAGACTTTAGCATACATTA
CTAGAGTCATGGTACTCCG -> TAGAGTCATGGTACTCCGG
CTAGCAATCGTTAATTCTA -> TAGCAATCGTTAATTCTAA
CTAGCTTCTAGCAATCGTT -> TAGCTTCTAGCAATCGTTA
CTAGGCTGAATAGAAGATT -> TAGGCTGAATAGAAGATTT
CTAGGGAGGGTGCCGAATG -> TAGGGAGGGTGCCGAATGC
CTAGGTCGTTAGCAGATCG -> TAGGTCGTTAGCAGATCGA
CTAGTAGCCTTAAGTCAGA -> TAGTAGCCTTAAGTCAGAC
CTATCAAAAACTAAGGGGG -> TATCAAAAACTAAGGGGGG
CTATGAGCATTTGGACTGA -> TATGAGCATTTGGACTGAA
CTATGCAGACCCGAACCCT -> TATGCAGACCCGAACCCTA
CTATGTAAGGGGACTTCCG -> TATGTAAGGGGACTTCCGC
CTCAAGTCGAAGTGAAACA -> TCAAGTCGAAGTGAAACAC
CTCACAAGGAAGAAATCGT -> TCACAAGGAAGAAATCGTG
CTCACTCCGGGACACTTGT -> TCACTCCGGGACACTTGTG
CTCAGAATCCCTAGACAAG -> TCAGAATCCCTAGACAAGG
CTCAGAATCCCTAGACCGT -> TCAGAATCCCTAGACCGTT
CTCAGAATCCCTAGACGGC -> TCAGAATCCCTAGACGGCC
CTCAGAATCCCTAGACTTT -> TCAGAATCCCTAGACTTTA
CTCAGGATGTTGCAGAATG -> TCAGGATGTTGCAGAATGA
CTCATCATTTAGACTCGTC -> TCATCATTTAGACTCGTCG
CTCCAATCTGAAGAAGGTT -> TCCAATCTGAAGAAGGTTT
CTCCAGTAGAAACTTCGTC -> TCCAGTAGAAACTTCGTCC
CTCCATGAATGTTCTAACA -> TCCATGAATGTTCTAACAA
CTCCCTCTTAGTGGGATCC -> TCCCTCTTAGTGGGATCCG
CTCCGGGACACTTGTGTAG -> TCCGGGACACTTGTGTAGC
CTCCGGGACACTTGTGTCA -> TCCGGGACACTTGTGTCAC
CTCCGGGACACTTGTGTGT -> TCCGGGACACTTGTGTGTA
CTCCGGGACACTTGTGTTC -> TCCGGGACACTTGTGTTCC
CTCCGTTAGGACGGGTCGC -> TCCGTTAGGACGGGTCGCG
CTCCTAAGAATACCCTACG -> TCCTAAGAATACCCTACGG
CTCCTAATACACTCCTCCA -> TCCTAATACACTCCTCCAG
CTCCTCCAGTAGAAACTTC -> TCCTCCAGTAGAAACTTCG
CTCCTTGCGGATCCGGTCA -> TCCTTGCGGATCCGGTCAT
CTCGCGATCGATGTGCGGG -> TCGCGATCGATGTGCGGGG
CTCGGGAGACTCCGGGACA -> TCGGGAGACTCCGGGACAC
CTCGTAGATAACCTCAGAA -> TCGTAGATAACCTCAGAAT
CTCGTCGTTATCCCCTAAT -> TCGTCGTTATCCCCTAATG
CTCTCCTAATACACTCCTC -> TCTCCTAATACACTCCTCC
CTCTCTGGGCCTACGCAGG -> TCTCTGGGCCTACGCAGGA
CTCTGGGCCTACGCAGGAT -> TCTGGGCCTACGCAGGATC
CTCTTAGTGGGATCCGTGA -> TCTTAGTGGGATCCGTGAT
CTCTTTGTCAGGTGGCAGG -> TCTTTGTCAGGTGGCAGGG
CTGAAGAAGGTTTCATTGG -> TGAAGAAGGTTTCATTGGA
CTGAATACTTTTGTCGAGC -> TGAATACTTTTGTCGAGCG
CTGAATAGAAGATTTCCAT -> TGAATAGAAGATTTCCATA
CTGACGGAGATAGTCGGGT -> TGACGGAGATAGTCGGGTC
CTGAGTAGGTCCTTGCAGC -> TGAGTAGGTCCTTGCAGCT
CTGATCTCGCGATCGATGT -> TGATCTCGCGATCGATGTG
CTGATGATCTGTTATAGGA -> TGATGATCTGTTATAGGAA
CTGCACCCGCTCCCTCTTA -> TGCACCCGCTCCCTCTTAG
CTGCACTGTCGAATTTGTT -> TGCACTGTCGAATTTGTTT
CTGCAGCCTGTAATTCCAC -> TGCAGCCTGTAATTCCACC
CTGCCGATCAGTGGCGAGT -> TGCCGATCAGTGGCGAGTG
CTGCGTGGGCACATTCTTA -> TGCGTGGGCACATTCTTAT
CTGCGTGTTGCAACGTTGA -> TGCGTGTTGCAACGTTGAT
CTGCTACTAAGACTCACTC -> TGCTACTAAGACTCACTCC
CTGCTGTCTTAGAGATAGC -> TGCTGTCTTAGAGATAGCG
CTGCTTGGCATCCTAACTT -> TGCTTGGCATCCTAACTTC
CTGGAGGGCAAGATACGCG -> TGGAGGGCAAGATACGCGG
CTGGCTATCAAAAACTAAG -> TGGCTATCAAAAACTAAGG
CTGGGCCTACGCAGGATCT -> TGGGCCTACGCAGGATCTT
CTGGGGAACTGGCTATCAA -> TGGGGAACTGGCTATCAAA
CTGGTACGAGACCGCTTGA -> TGGTACGAGACCGCTTGAA
CTGGTTGATATCCGAGCAG -> TGGTTGATATCCGAGCAGT
CTGTAATTCCACCCGTCAT -> TGTAATTCCACCCGTCATG
CTGTCGAATTTGTTTTTGG -> TGTCGAATTTGTTTTTGGT
CTGTCTAGAGTCATGGTAC -> TGTCTAGAGTCATGGTACT
CTGTCTGTCTAGAGTCATG -> TGTCTGTCTAGAGTCATGG
CTGTCTTAGAGATAGCGAG -> TGTCTTAGAGATAGCGAGA
CTGTTATAGGAAGTTTAGG -> TGTTATAGGAAGTTTAGGT
CTGTTATCTTGGTGTAGGC -> TGTTATCTTGGTGTAGGCC
CTGTTTAACGTCTGAGTAG -> TGTTTAACGTCTGAGTAGG
CTTAAGTCAGACAATGTGG -> TTAAGTCAGACAATGTGGC
CTTACTCAGGATGTTGCAG -> TTACTCAGGATGTTGCAGA
CTTAGAGATAGCGAGAATC -> TTAGAGATAGCGAGAATCA
CTTAGTGGGATCCGTGATT -> TTAGTGGGATCCGTGATTA
CTTATAATAGTCCCTTCTA -> TTATAATAGTCCCTTCTAA
CTTATCCCGGACCTTGCGT -> TTATCCCGGACCTTGCGTT
CTTCCAACAAAGCCGAATC -> TTCCAACAAAGCCGAATCA
CTTCCGCGCAGAATGCGGC -> TTCCGCGCAGAATGCGGCC
CTTCGTACATACCGGCAGC -> TTCGTACATACCGGCAGCA
CTTCGTCCCGAGTAGGCAG -> TTCGTCCCGAGTAGGCAGA
CTTCTAAGCCTACAGCCTT -> TTCTAAGCCTACAGCCTTA
CTTCTAATTAGTTGTAGTT -> TTCTAATTAGTTGTAGTTC
CTTCTAGAAGGAGTCAACT -> TTCTAGAAGGAGTCAACTG
CTTCTAGCAATCGTTAATT -> TTCTAGCAATCGTTAATTC
CTTCTTCTAATTAGTTGTA -> TTCTTCTAATTAGTTGTAG
CTTGAATCAAACCATTACA -> TTGAATCAAACCATTACAT
CTTGCAGCTCCTAAGAATA -> TTGCAGCTCCTAAGAATAC
CTTGCCGTACCGATCCGCT -> TTGCCGTACCGATCCGCTT
CTTGCGGATCCGGTCATCG -> TTGCGGATCCGGTCATCGT
CTTGCGTTTGAATGTATGA -> TTGCGTTTGAATGTATGAC
CTTGGCATCCTAACTTCTT -> TTGGCATCCTAACTTCTTC
CTTGGGAAGCCGTACATGG -> TTGGGAAGCCGTACATGGT
CTTGGTGTAGGCCGGGATT -> TTGGTGTAGGCCGGGATTT
CTTGTCGGAAATCGAGTAT -> TTGTCGGAAATCGAGTATT
CTTGTGTAGCTCGTAGATA -> TTGTGTAGCTCGTAGATAA
CTTGTGTCACGCACGTCGA -> TTGTGTCACGCACGTCGAA
CTTGTGTGTAGTGGGTTCA -> TTGTGTGTAGTGGGTTCAA
CTTGTGTTCCCGGCGGGCA -> TTGTGTTCCCGGCGGGCAA
CTTGTTATAGGGGCCCCCG -> TTGTTATAGGGGCCCCCGA
CTTTAGATTCCCACGTTCC -> TTTAGATTCCCACGTTCCT
CTTTAGCATACATTAACAT -> TTTAGCATACATTAACATC
CTTTGTCAGGTGGCAGGGC -> TTTGTCAGGTGGCAGGGCC
CTTTTGATACATGTTCGCA -> TTTTGATACATGTTCGCAA
CTTTTGTCGAGCGAAACCA -> TTTTGTCGAGCGAAACCAT
CTTTTTACTATGTAAGGGG -> TTTTTACTATGTAAGGGGA
GAAACACCTAGGCTGAATA -> AAACACCTAGGCTGAATAG
GAAACCATTAGCCCAGGTG -> AAACCATTAGCCCAGGTGA
GAAACGAATTCATAGCGGT -> AAACGAATTCATAGCGGTC
GAAACTTCGTCCCGAGTAG -> AAACTTCGTCCCGAGTAGG
GAAATCGAGTATTCTTACT -> AAATCGAGTATTCTTACTC
GAAATCGTGAGGCGCCTCG -> AAATCGTGAGGCGCCTCGG
GAAATGGTAGTTCAAATTA -> AAATGGTAGTTCAAATTAG
GAACATGAAACGAATTCAT -> AACATGAAACGAATTCATA
GAACATGTCGATGTGGGGT -> AACATGTCGATGTGGGGTG
GAACCCTAAATGTTCAAAG -> AACCCTAAATGTTCAAAGC
GAACCTCAGAATCCCTAGA -> AACCTCAGAATCCCTAGAC
GAACTGGCTATCAAAAACT -> AACTGGCTATCAAAAACTA
GAAGAAATCGTGAGGCGCC -> AAGAAATCGTGAGGCGCCT
GAAGAAGGTTTCATTGGAG -> AAGAAGGTTTCATTGGAGT
GAAGATTTCCATAACCCAG -> AAGATTTCCATAACCCAGT
GAAGCCGTACATGGTAGTG -> AAGCCGTACATGGTAGTGT
GAAGGAGTCAACTGCCGAT -> AAGGAGTCAACTGCCGATC
GAAGGTCGCAGCTGCGTGT -> AAGGTCGCAGCTGCGTGTT
GAAGGTTTCATTGGAGTCA -> AAGGTTTCATTGGAGTCAA
GAAGTGAAACACCTAGGCT -> AAGTGAAACACCTAGGCTG
GAAGTTTAGGTGTAGACTG -> AAGTTTAGGTGTAGACTGT
GAATACCCTACGGTGGGAG -> AATACCCTACGGTGGGAGG
GAATACTTTTGTCGAGCGA -> AATACTTTTGTCGAGCGAA
GAATAGAAGATTTCCATAA -> AATAGAAGATTTCCATAAC
GAATCAAACCATTACATCA -> AATCAAACCATTACATCAC
GAATCATAACAGCACCAAC -> AATCATAACAGCACCAACA
GAATCATAGGTCTCATCAT -> AATCATAGGTCTCATCATT
GAATCATCGGCGACAACCA -> AATCATCGGCGACAACCAT
GAATCCCTAGACAAGGGAG -> AATCCCTAGACAAGGGAGG
GAATCCCTAGACCGTTAAC -> AATCCCTAGACCGTTAACG
GAATCCCTAGACGGCCCGT -> AATCCCTAGACGGCCCGTG
GAATCCCTAGACTTTAGCA -> AATCCCTAGACTTTAGCAT
GAATGATCCAAAGCGGGCT -> AATGATCCAAAGCGGGCTG
GAATGATCCGCAGGAGCCT -> AATGATCCGCAGGAGCCTG
GAATGCGGCCTAAATCCAC -> AATGCGGCCTAAATCCACA
GAATGCTCTTTGTCAGGTG -> AATGCTCTTTGTCAGGTGG
GAATGGTGTTACGTCGCCC -> AATGGTGTTACGTCGCCCT
GAATGTATGACTCACAAGG -> AATGTATGACTCACAAGGA
GAATGTTCTAACAATGTAT -> AATGTTCTAACAATGTATA
GAATTCATAGCGGTCAACA -> AATTCATAGCGGTCAACAC
GAATTTGTTTTTGGTGTAG -> AATTTGTTTTTGGTGTAGT
GACAAAGCGCGTTACAACG -> ACAAAGCGCGTTACAACGT
GACAACCATCGAAGGTCGC -> ACAACCATCGAAGGTCGCA
GACAAGGGAGGCATAGTCG -> ACAAGGGAGGCATAGTCGC
GACAATGTGGCCCGGATAG -> ACAATGTGGCCCGGATAGG
GACACGATAAAGGTGCGCC -> ACACGATAAAGGTGCGCCA
GACACTTGTGTAGCTCGTA -> ACACTTGTGTAGCTCGTAG
GACACTTGTGTCACGCACG -> ACACTTGTGTCACGCACGT
GACACTTGTGTGTAGTGGG -> ACACTTGTGTGTAGTGGGT
GACACTTGTGTTCCCGGCG -> ACACTTGTGTTCCCGGCGG
GACATACCTCCGTTAGGAC -> ACATACCTCCGTTAGGACG
GACCCGAACCCTAAATGTT -> ACCCGAACCCTAAATGTTC
GACCGCTTGAATCAAACCA -> ACCGCTTGAATCAAACCAT
GACCGTTAACGGTAATCCA -> ACCGTTAACGGTAATCCAC
GACCTAACTCCAATCTGAA -> ACCTAACTCCAATCTGAAG
GACCTAGGGAGGGTGCCGA -> ACCTAGGGAGGGTGCCGAA
GACCTTGCGTTTGAATGTA -> ACCTTGCGTTTGAATGTAT
GACGCTGGAGGGCAAGATA -> ACGCTGGAGGGCAAGATAC
GACGGAGATAGTCGGGTCG -> ACGGAGATAGTCGGGTCGC
GACGGAGTATTTTCACTTT -> ACGGAGTATTTTCACTTTT
GACGGCCCGTGTGCTTGTC -> ACGGCCCGTGTGCTTGTCG
GACGGGTCGCGTTTAGATC -> ACGGGTCGCGTTTAGATCT
GACTAGGTCGTTAGCAGAT -> ACTAGGTCGTTAGCAGATC
GACTCACAAGGAAGAAATC -> ACTCACAAGGAAGAAATCG
GACTCACTCCGGGACACTT -> ACTCACTCCGGGACACTTG
GACTCCGGGACACTTGTGT -> ACTCCGGGACACTTGTGTG
GACTCGTCGTTATCCCCTA -> ACTCGTCGTTATCCCCTAA
GACTGAATACTTTTGTCGA -> ACTGAATACTTTTGTCGAG
GACTGGTACGAGACCGCTT -> ACTGGTACGAGACCGCTTG
GACTGTCTGTCTAGAGTCA -> ACTGTCTGTCTAGAGTCAT
GACTTCCAACAAAGCCGAA -> ACTTCCAACAAAGCCGAAT
GACTTCCGCGCAGAATGCG -> ACTTCCGCGCAGAATGCGG
GACTTTAGCATACATTAAC -> ACTTTAGCATACATTAACA
GAGAATCATCGGCGACAAC -> AGAATCATCGGCGACAACC
GAGACCGCTTGAATCAAAC -> AGACCGCTTGAATCAAACC
GAGACTCCGGGACACTTGT -> AGACTCCGGGACACTTGTG
GAGACTGGTACGAGACCGC -> AGACTGGTACGAGACCGCT
GAGATAGCGAGAATCATCG -> AGATAGCGAGAATCATCGG
GAGATAGTCGGGTCGCTAG -> AGATAGTCGGGTCGCTAGT
GAGCAGTTCTCAAGTCGAA -> AGCAGTTCTCAAGTCGAAG
GAGCATTTGGACTGAATAC -> AGCATTTGGACTGAATACT
GAGCCTGCGTGGGCACATT -> AGCCTGCGTGGGCACATTC
GAGCCTTCTAGAAGGAGTC -> AGCCTTCTAGAAGGAGTCA
GAGCGAAACCATTAGCCCA -> AGCGAAACCATTAGCCCAG
GAGGATAGTCCTAAAAGAG -> AGGATAGTCCTAAAAGAGG
GAGGATCCACTAAGAACAT -> AGGATCCACTAAGAACATG
GAGGCATAGTCGCGGAGCC -> AGGCATAGTCGCGGAGCCT
GAGGCCCCGTCTATGAGCA -> AGGCCCCGTCTATGAGCAT
GAGGCGCCTCGGGAGACTC -> AGGCGCCTCGGGAGACTCC
GAGGGCAAGATACGCGGCA -> AGGGCAAGATACGCGGCAA
GAGGGGAACATGAAACGAA -> AGGGGAACATGAAACGAAT
GAGGGGGGATAATGCAGGA -> AGGGGGGATAATGCAGGAA
GAGGGTGCCGAATGCTCTT -> AGGGTGCCGAATGCTCTTT
GAGGTTTGGTACTCCTTGC -> AGGTTTGGTACTCCTTGCG
GAGTAGGCAGAGGATAGTC -> AGTAGGCAGAGGATAGTCC
GAGTAGGTCCTTGCAGCTC -> AGTAGGTCCTTGCAGCTCC
GAGTATTCTTACTCAGGAT -> AGTATTCTTACTCAGGATG
GAGTATTTTCACTTTTTAC -> AGTATTTTCACTTTTTACT
GAGTCAACTGCCGATCAGT -> AGTCAACTGCCGATCAGTG
GAGTCAAGCCACCGGGTCC -> AGTCAAGCCACCGGGTCCT
GAGTCATGGTACTCCGGGA -> AGTCATGGTACTCCGGGAC
GAGTGTGTCAACGACCTAA -> AGTGTGTCAACGACCTAAC
GATAAAGGTGCGCCAGTAA -> ATAAAGGTGCGCCAGTAAC
GATAACCTCAGAATCCCTA -> ATAACCTCAGAATCCCTAG
GATAATGCAGGAATCATAA -> ATAATGCAGGAATCATAAC
GATACATGTTCGCAACCCA -> ATACATGTTCGCAACCCAT
GATACGCGGCAACCACGGT -> ATACGCGGCAACCACGGTA
GATAGCGAGAATCATCGGC -> ATAGCGAGAATCATCGGCG
GATAGGGACGGAGTATTTT -> ATAGGGACGGAGTATTTTC
GATAGTCCACGTTCTCTCT -> ATAGTCCACGTTCTCTCTG
GATAGTCCTAAAAGAGGGG -> ATAGTCCTAAAAGAGGGGA
GATAGTCGGGTCGCTAGTA -> ATAGTCGGGTCGCTAGTAG
GATATAAAAAATAACATGG -> ATATAAAAAATAACATGGG
GATATCCGAGCAGTTCTCA -> ATATCCGAGCAGTTCTCAA
GATCACCAGAATGATCCGC -> ATCACCAGAATGATCCGCA
GATCAGTGGCGAGTGTGTC -> ATCAGTGGCGAGTGTGTCA
GATCCAAAGCGGGCTGCTG -> ATCCAAAGCGGGCTGCTGT
GATCCACTAAGAACATGTC -> ATCCACTAAGAACATGTCG
GATCCGCAGGAGCCTGCGT -> ATCCGCAGGAGCCTGCGTG
GATCCGCTTTTGATACATG -> ATCCGCTTTTGATACATGT
GATCCGGTCATCGTGATAT -> ATCCGGTCATCGTGATATA
GATCCGTGATTAACTCCGG -> ATCCGTGATTAACTCCGGG
GATCGACACGATAAAGGTG -> ATCGACACGATAAAGGTGC
GATCGATGTGCGGGGTGTT -> ATCGATGTGCGGGGTGTTG
GATCTCGCGATCGATGTGC -> ATCTCGCGATCGATGTGCG
GATCTGGTTGATATCCGAG -> ATCTGGTTGATATCCGAGC
GATCTGTTATAGGAAGTTT -> ATCTGTTATAGGAAGTTTA
GATCTTGGGAAGCCGTACA -> ATCTTGGGAAGCCGTACAT
GATGATCTGTTATAGGAAG -> ATGATCTGTTATAGGAAGT
GATGGCTTTAGATTCCCAC -> ATGGCTTTAGATTCCCACG
GATGTGCGGGGTGTTGTCT -> ATGTGCGGGGTGTTGTCTG
GATGTGGGGTGTGATTAAC -> ATGTGGGGTGTGATTAACC
GATGTTGCAGAATGATCCA -> ATGTTGCAGAATGATCCAA
GATTAACCCGTTAATGGAT -> ATTAACCCGTTAATGGATC
GATTAACTCCGGGACACTT -> ATTAACTCCGGGACACTTG
GATTCCCACGTTCCTATGC -> ATTCCCACGTTCCTATGCA
GATTTCCATAACCCAGTCT -> ATTTCCATAACCCAGTCTG
GATTTTCCCATGGCCGCCG -> ATTTTCCCATGGCCGCCGG
GCAACCACGGTATACCTTG -> CAACCACGGTATACCTTGT
GCAACCCATAGGGCGGCAG -> CAACCCATAGGGCGGCAGC
GCAACCTCAGAATCCCTAG -> CAACCTCAGAATCCCTAGA
GCAACGTTGATAGTCCACG -> CAACGTTGATAGTCCACGT
GCAAGATACGCGGCAACCA -> CAAGATACGCGGCAACCAC
GCAATCGTTAATTCTAATG -> CAATCGTTAATTCTAATGG
GCAATGTCTAATCTGCTAC -> CAATGTCTAATCTGCTACT
GCACATTCTTATAATAGTC -> CACATTCTTATAATAGTCC
GCACCAACACACCCCAAAA -> CACCAACACACCCCAAAAC
GCACCCGCTCCCTCTTAGT -> CACCCGCTCCCTCTTAGTG
GCACGTCGAACCTCAGAAT -> CACGTCGAACCTCAGAATC
GCACTGTCGAATTTGTTTT -> CACTGTCGAATTTGTTTTT
GCAGAATGATCCAAAGCGG -> CAGAATGATCCAAAGCGGG
GCAGAATGCGGCCTAAATC -> CAGAATGCGGCCTAAATCC
GCAGACCCGAACCCTAAAT -> CAGACCCGAACCCTAAATG
GCAGAGGATAGTCCTAAAA -> CAGAGGATAGTCCTAAAAG
GCAGATCGACACGATAAAG -> CAGATCGACACGATAAAGG
GCAGCAGTATTTACTGATG -> CAGCAGTATTTACTGATGA
GCAGCCTGTAATTCCACCC -> CAGCCTGTAATTCCACCCG
GCAGCTCCATGAATGTTCT -> CAGCTCCATGAATGTTCTA
GCAGCTCCTAAGAATACCC -> CAGCTCCTAAGAATACCCT
GCAGCTGCGTGTTGCAACG -> CAGCTGCGTGTTGCAACGT
GCAGCTGCTTGGCATCCTA -> CAGCTGCTTGGCATCCTAA
GCAGGAATCATAACAGCAC -> CAGGAATCATAACAGCACC
GCAGGAGCCTGCGTGGGCA -> CAGGAGCCTGCGTGGGCAC
GCAGGATCTTGGGAAGCCG -> CAGGATCTTGGGAAGCCGT
GCAGGGCCACTGTTATCTT -> CAGGGCCACTGTTATCTTG
GCAGTATTTACTGATGATC -> CAGTATTTACTGATGATCT
GCAGTTCTCAAGTCGAAGT -> CAGTTCTCAAGTCGAAGTG
GCATACATTAACATCCCTA -> CATACATTAACATCCCTAG
GCATAGTCGCGGAGCCTTC -> CATAGTCGCGGAGCCTTCT
GCATCCTAACTTCTTCTAA -> CATCCTAACTTCTTCTAAT
GCATTCTGGGGAACTGGCT -> CATTCTGGGGAACTGGCTA
GCATTTGGACTGAATACTT -> CATTTGGACTGAATACTTT
GCCACCGGGTCCTGTTTAA -> CCACCGGGTCCTGTTTAAC
GCCACTGTTATCTTGGTGT -> CCACTGTTATCTTGGTGTA
GCCAGTAACCGATGGCTTT -> CCAGTAACCGATGGCTTTA
GCCCAGGTGACTAGGTCGT -> CCCAGGTGACTAGGTCGTT
GCCCCATTATCGCAGCTCC -> CCCCATTATCGCAGCTCCA
GCCCCCGAGGATCCACTAA -> CCCCCGAGGATCCACTAAG
GCCCCGTCTATGAGCATTT -> CCCCGTCTATGAGCATTTG
GCCCGGATAGGGACGGAGT -> CCCGGATAGGGACGGAGTA
GCCCGTGTGCTTGTCGGAA -> CCCGTGTGCTTGTCGGAAA
GCCCTGCACCCGCTCCCTC -> CCCTGCACCCGCTCCCTCT
GCCGAATCATAGGTCTCAT -> CCGAATCATAGGTCTCATC
GCCGAATGCTCTTTGTCAG -> CCGAATGCTCTTTGTCAGG
GCCGACTTCCAACAAAGCC -> CCGACTTCCAACAAAGCCG
GCCGATCAGTGGCGAGTGT -> CCGATCAGTGGCGAGTGTG
GCCGCCGGTGCTAATTGTC -> CCGCCGGTGCTAATTGTCC
GCCGGGATTTTCCCATGGC -> CCGGGATTTTCCCATGGCC
GCCGGTGCTAATTGTCCGT -> CCGGTGCTAATTGTCCGTC
GCCGTACATGGTAGTGTGC -> CCGTACATGGTAGTGTGCA
GCCGTACCGATCCGCTTTT -> CCGTACCGATCCGCTTTTG
GCCTAAATCCACATTTAGT -> CCTAAATCCACATTTAGTC
GCCTACAGCCTTATCCCGG -> CCTACAGCCTTATCCCGGA
GCCTACGCAGGATCTTGGG -> CCTACGCAGGATCTTGGGA
GCCTCGGGAGACTCCGGGA -> CCTCGGGAGACTCCGGGAC
GCCTGATCTCGCGATCGAT -> CCTGATCTCGCGATCGATG
GCCTGCGTGGGCACATTCT -> CCTGCGTGGGCACATTCTT
GCCTGTAATTCCACCCGTC -> CCTGTAATTCCACCCGTCA
GCCTTAAGTCAGACAATGT -> CCTTAAGTCAGACAATGTG
GCCTTATCCCGGACCTTGC -> CCTTATCCCGGACCTTGCG
GCCTTCTAGAAGGAGTCAA -> CCTTCTAGAAGGAGTCAAC
GCGAAACCATTAGCCCAGG -> CGAAACCATTAGCCCAGGT
GCGAAATGGTAGTTCAAAT -> CGAAATGGTAGTTCAAATT
GCGACAACCATCGAAGGTC -> CGACAACCATCGAAGGTCG
GCGAGAATCATCGGCGACA -> CGAGAATCATCGGCGACAA
GCGAGGCCCCGTCTATGAG -> CGAGGCCCCGTCTATGAGC
GCGAGTGTGTCAACGACCT -> CGAGTGTGTCAACGACCTA
GCGATCGATGTGCGGGGTG -> CGATCGATGTGCGGGGTGT
GCGCAGAATGCGGCCTAAA -> CGCAGAATGCGGCCTAAAT
GCGCCAGTAACCGATGGCT -> CGCCAGTAACCGATGGCTT
GCGCCTCGGGAGACTCCGG -> CGCCTCGGGAGACTCCGGG
GCGCGAAATGGTAGTTCAA -> CGCGAAATGGTAGTTCAAA
GCGCGTTACAACGTCCAGC -> CGCGTTACAACGTCCAGCC
GCGGAGCCTTCTAGAAGGA -> CGGAGCCTTCTAGAAGGAG
GCGGATCCGGTCATCGTGA -> CGGATCCGGTCATCGTGAT
GCGGCAACCACGGTATACC -> CGGCAACCACGGTATACCT
GCGGCAGCTGCTTGGCATC -> CGGCAGCTGCTTGGCATCC
GCGGCCTAAATCCACATTT -> CGGCCTAAATCCACATTTA
GCGGGCAACCTCAGAATCC -> CGGGCAACCTCAGAATCCC
GCGGGCTGCTGTCTTAGAG -> CGGGCTGCTGTCTTAGAGA
GCGGGGTGTTGTCTGACGG -> CGGGGTGTTGTCTGACGGA
GCGGTCAACACGTTGCCTG -> CGGTCAACACGTTGCCTGA
GCGTGGGCACATTCTTATA -> CGTGGGCACATTCTTATAA
GCGTGTTGCAACGTTGATA -> CGTGTTGCAACGTTGATAG
GCGTTACAACGTCCAGCCG -> CGTTACAACGTCCAGCCGA
GCGTTTAGATCTGGTTGAT -> CGTTTAGATCTGGTTGATA
GCGTTTGAATGTATGACTC -> CGTTTGAATGTATGACTCA
GCTAATTGTCCGTCAGGCG -> CTAATTGTCCGTCAGGCGA
GCTACTAAGACTCACTCCG -> CTACTAAGACTCACTCCGG
GCTAGTAGCCTTAAGTCAG -> CTAGTAGCCTTAAGTCAGA
GCTATCAAAAACTAAGGGG -> CTATCAAAAACTAAGGGGG
GCTCCATGAATGTTCTAAC -> CTCCATGAATGTTCTAACA
GCTCCCTCTTAGTGGGATC -> CTCCCTCTTAGTGGGATCC
GCTCCTAAGAATACCCTAC -> CTCCTAAGAATACCCTACG
GCTCGTAGATAACCTCAGA -> CTCGTAGATAACCTCAGAA
GCTCTTTGTCAGGTGGCAG -> CTCTTTGTCAGGTGGCAGG
GCTGAATAGAAGATTTCCA -> CTGAATAGAAGATTTCCAT
GCTGCGTGTTGCAACGTTG -> CTGCGTGTTGCAACGTTGA
GCTGCTGTCTTAGAGATAG -> CTGCTGTCTTAGAGATAGC
GCTGCTTGGCATCCTAACT -> CTGCTTGGCATCCTAACTT
GCTGGAGGGCAAGATACGC -> CTGGAGGGCAAGATACGCG
GCTGTCTTAGAGATAGCGA -> CTGTCTTAGAGATAGCGAG
GCTTCGTACATACCGGCAG -> CTTCGTACATACCGGCAGC
GCTTCTAGCAATCGTTAAT -> CTTCTAGCAATCGTTAATT
GCTTGAATCAAACCATTAC -> CTTGAATCAAACCATTACA
GCTTGGCATCCTAACTTCT -> CTTGGCATCCTAACTTCTT
GCTTGTCGGAAATCGAGTA -> CTTGTCGGAAATCGAGTAT
GCTTTAGATTCCCACGTTC -> CTTTAGATTCCCACGTTCC
GCTTTTGATACATGTTCGC -> CTTTTGATACATGTTCGCA
GGAAATCGAGTATTCTTAC -> GAAATCGAGTATTCTTACT
GGAACATGAAACGAATTCA -> GAACATGAAACGAATTCAT
GGAACTGGCTATCAAAAAC -> GAACTGGCTATCAAAAACT
GGAAGAAATCGTGAGGCGC -> GAAGAAATCGTGAGGCGCC
GGAAGCCGTACATGGTAGT -> GAAGCCGTACATGGTAGTG
GGAAGTTTAGGTGTAGACT -> GAAGTTTAGGTGTAGACTG
GGAATCATAACAGCACCAA -> GAATCATAACAGCACCAAC
GGACACTTGTGTAGCTCGT -> GACACTTGTGTAGCTCGTA
GGACACTTGTGTCACGCAC -> GACACTTGTGTCACGCACG
GGACACTTGTGTGTAGTGG -> GACACTTGTGTGTAGTGGG
GGACACTTGTGTTCCCGGC -> GACACTTGTGTTCCCGGCG
GGACCTAGGGAGGGTGCCG -> GACCTAGGGAGGGTGCCGA
GGACCTTGCGTTTGAATGT -> GACCTTGCGTTTGAATGTA
GGACGCTGGAGGGCAAGAT -> GACGCTGGAGGGCAAGATA
GGACGGAGTATTTTCACTT -> GACGGAGTATTTTCACTTT
GGACGGGTCGCGTTTAGAT -> GACGGGTCGCGTTTAGATC
GGACTGAATACTTTTGTCG -> GACTGAATACTTTTGTCGA
GGACTTCCGCGCAGAATGC -> GACTTCCGCGCAGAATGCG
GGAGACTCCGGGACACTTG -> GAGACTCCGGGACACTTGT
GGAGATAGTCGGGTCGCTA -> GAGATAGTCGGGTCGCTAG
GGAGCCTGCGTGGGCACAT -> GAGCCTGCGTGGGCACATT
GGAGCCTTCTAGAAGGAGT -> GAGCCTTCTAGAAGGAGTC
GGAGGCATAGTCGCGGAGC -> GAGGCATAGTCGCGGAGCC
GGAGGGCAAGATACGCGGC -> GAGGGCAAGATACGCGGCA
GGAGGGGGGATAATGCAGG -> GAGGGGGGATAATGCAGGA
GGAGGGTGCCGAATGCTCT -> GAGGGTGCCGAATGCTCTT
GGAGTATTTTCACTTTTTA -> GAGTATTTTCACTTTTTAC
GGAGTCAACTGCCGATCAG -> GAGTCAACTGCCGATCAGT
GGAGTCAAGCCACCGGGTC -> GAGTCAAGCCACCGGGTCC
GGATAATGCAGGAATCATA -> GATAATGCAGGAATCATAA
GGATAGGGACGGAGTATTT -> GATAGGGACGGAGTATTTT
GGATAGTCCTAAAAGAGGG -> GATAGTCCTAAAAGAGGGG
GGATCACCAGAATGATCCG -> GATCACCAGAATGATCCGC
GGATCCACTAAGAACATGT -> GATCCACTAAGAACATGTC
GGATCCGGTCATCGTGATA -> GATCCGGTCATCGTGATAT
GGATCCGTGATTAACTCCG -> GATCCGTGATTAACTCCGG
GGATCTTGGGAAGCCGTAC -> GATCTTGGGAAGCCGTACA
GGATGTTGCAGAATGATCC -> GATGTTGCAGAATGATCCA
GGATTTTCCCATGGCCGCC -> GATTTTCCCATGGCCGCCG
GGCAACCACGGTATACCTT -> GCAACCACGGTATACCTTG
GGCAACCTCAGAATCCCTA -> GCAACCTCAGAATCCCTAG
GGCAAGATACGCGGCAACC -> GCAAGATACGCGGCAACCA
GGCACATTCTTATAATAGT -> GCACATTCTTATAATAGTC
GGCAGAGGATAGTCCTAAA -> GCAGAGGATAGTCCTAAAA
GGCAGCAGTATTTACTGAT -> GCAGCAGTATTTACTGATG
GGCAGCTGCTTGGCATCCT -> GCAGCTGCTTGGCATCCTA
GGCAGGGCCACTGTTATCT -> GCAGGGCCACTGTTATCTT
GGCATAGTCGCGGAGCCTT -> GCATAGTCGCGGAGCCTTC
GGCATCCTAACTTCTTCTA -> GCATCCTAACTTCTTCTAA
GGCATTCTGGGGAACTGGC -> GCATTCTGGGGAACTGGCT
GGCCACTGTTATCTTGGTG -> GCCACTGTTATCTTGGTGT
GGCCCCCGAGGATCCACTA -> GCCCCCGAGGATCCACTAA
GGCCCCGTCTATGAGCATT -> GCCCCGTCTATGAGCATTT
GGCCCGGATAGGGACGGAG -> GCCCGGATAGGGACGGAGT
GGCCCGTGTGCTTGTCGGA -> GCCCGTGTGCTTGTCGGAA
GGCCGCCGGTGCTAATTGT -> GCCGCCGGTGCTAATTGTC
GGCCGGGATTTTCCCATGG -> GCCGGGATTTTCCCATGGC
GGCCTAAATCCACATTTAG -> GCCTAAATCCACATTTAGT
GGCCTACGCAGGATCTTGG -> GCCTACGCAGGATCTTGGG
GGCGACAACCATCGAAGGT -> GCGACAACCATCGAAGGTC
GGCGAGGCCCCGTCTATGA -> GCGAGGCCCCGTCTATGAG
GGCGAGTGTGTCAACGACC -> GCGAGTGTGTCAACGACCT
GGCGCCTCGGGAGACTCCG -> GCGCCTCGGGAGACTCCGG
GGCGGCAGCTGCTTGGCAT -> GCGGCAGCTGCTTGGCATC
GGCGGGCAACCTCAGAATC -> GCGGGCAACCTCAGAATCC
GGCTATCAAAAACTAAGGG -> GCTATCAAAAACTAAGGGG
GGCTGAATAGAAGATTTCC -> GCTGAATAGAAGATTTCCA
GGCTGCTGTCTTAGAGATA -> GCTGCTGTCTTAGAGATAG
GGCTTCGTACATACCGGCA -> GCTTCGTACATACCGGCAG
GGCTTTAGATTCCCACGTT -> GCTTTAGATTCCCACGTTC
GGGAACATGAAACGAATTC -> GGAACATGAAACGAATTCA
GGGAACTGGCTATCAAAAA -> GGAACTGGCTATCAAAAAC
GGGAAGCCGTACATGGTAG -> GGAAGCCGTACATGGTAGT
GGGACACTTGTGTAGCTCG -> GGACACTTGTGTAGCTCGT
GGGACACTTGTGTCACGCA -> GGACACTTGTGTCACGCAC
GGGACACTTGTGTGTAGTG -> GGACACTTGTGTGTAGTGG
GGGACACTTGTGTTCCCGG -> GGACACTTGTGTTCCCGGC
GGGACGGAGTATTTTCACT -> GGACGGAGTATTTTCACTT
GGGACTTCCGCGCAGAATG -> GGACTTCCGCGCAGAATGC
GGGAGACTCCGGGACACTT -> GGAGACTCCGGGACACTTG
GGGAGGCATAGTCGCGGAG -> GGAGGCATAGTCGCGGAGC
GGGAGGGGGGATAATGCAG -> GGAGGGGGGATAATGCAGG
GGGAGGGTGCCGAATGCTC -> GGAGGGTGCCGAATGCTCT
GGGATAATGCAGGAATCAT -> GGATAATGCAGGAATCATA
GGGATCCGTGATTAACTCC -> GGATCCGTGATTAACTCCG
GGGATTTTCCCATGGCCGC -> GGATTTTCCCATGGCCGCC
GGGCAACCTCAGAATCCCT -> GGCAACCTCAGAATCCCTA
GGGCAAGATACGCGGCAAC -> GGCAAGATACGCGGCAACC
GGGCACATTCTTATAATAG -> GGCACATTCTTATAATAGT
GGGCCACTGTTATCTTGGT -> GGCCACTGTTATCTTGGTG
GGGCCCCCGAGGATCCACT -> GGCCCCCGAGGATCCACTA
GGGCCTACGCAGGATCTTG -> GGCCTACGCAGGATCTTGG
GGGCGGCAGCTGCTTGGCA -> GGCGGCAGCTGCTTGGCAT
GGGCTGCTGTCTTAGAGAT -> GGCTGCTGTCTTAGAGATA
GGGGAACATGAAACGAATT -> GGGAACATGAAACGAATTC
GGGGAACTGGCTATCAAAA -> GGGAACTGGCTATCAAAAA
GGGGACTTCCGCGCAGAAT -> GGGACTTCCGCGCAGAATG
GGGGATAATGCAGGAATCA -> GGGATAATGCAGGAATCAT
GGGGCCCCCGAGGATCCAC -> GGGCCCCCGAGGATCCACT
GGGGGATAATGCAGGAATC -> GGGGATAATGCAGGAATCA
GGGGGGATAATGCAGGAAT -> GGGGGATAATGCAGGAATC
GGGGGGTCCCGCCTTTTAC -> GGGGGTCCCGCCTTTTACA
GGGGGTCCCGCCTTTTACA -> GGGGTCCCGCCTTTTACAG
GGGGTCCCGCCTTTTACAG -> GGGTCCCGCCTTTTACAGT
GGGGTGTGATTAACCCGTT -> GGGTGTGATTAACCCGTTA
GGGGTGTTGTCTGACGGAG -> GGGTGTTGTCTGACGGAGA
GGGTATTCTAGACATACCT -> GGTATTCTAGACATACCTC
GGGTCCCGCCTTTTACAGT -> GGTCCCGCCTTTTACAGTC
GGGTCCTGTTTAACGTCTG -> GGTCCTGTTTAACGTCTGA
GGGTCGCGTTTAGATCTGG -> GGTCGCGTTTAGATCTGGT
GGGTCGCTAGTAGCCTTAA -> GGTCGCTAGTAGCCTTAAG
GGGTGCCGAATGCTCTTTG -> GGTGCCGAATGCTCTTTGT
GGGTGTGATTAACCCGTTA -> GGTGTGATTAACCCGTTAA
GGGTGTTGTCTGACGGAGA -> GGTGTTGTCTGACGGAGAT
GGGTTCAACCTCAGAATCC -> GGTTCAACCTCAGAATCCC
GGTAATCCACTTGCCGTAC -> GTAATCCACTTGCCGTACC
GGTACGAGACCGCTTGAAT -> GTACGAGACCGCTTGAATC
GGTACTCCGGGACACTTGT -> GTACTCCGGGACACTTGTG
GGTACTCCTTGCGGATCCG -> GTACTCCTTGCGGATCCGG
GGTAGTGTGCAATGTCTAA -> GTAGTGTGCAATGTCTAAT
GGTAGTTCAAATTAGTGAC -> GTAGTTCAAATTAGTGACA
GGTATACCTTGTTATAGGG -> GTATACCTTGTTATAGGGG
GGTATTCTAGACATACCTC -> GTATTCTAGACATACCTCC
GGTCAACACGTTGCCTGAT -> GTCAACACGTTGCCTGATC
GGTCATCGTGATATAAAAA -> GTCATCGTGATATAAAAAA
GGTCCCGCCTTTTACAGTC -> GTCCCGCCTTTTACAGTCT
GGTCCTGTTTAACGTCTGA -> GTCCTGTTTAACGTCTGAG
GGTCCTTGCAGCTCCTAAG -> GTCCTTGCAGCTCCTAAGA
GGTCGCAGCTGCGTGTTGC -> GTCGCAGCTGCGTGTTGCA
GGTCGCCCCATTATCGCAG -> GTCGCCCCATTATCGCAGC
GGTCGCGTTTAGATCTGGT -> GTCGCGTTTAGATCTGGTT
GGTCGCTAGTAGCCTTAAG -> GTCGCTAGTAGCCTTAAGT
GGTCGGCTTCGTACATACC -> GTCGGCTTCGTACATACCG
GGTCGTTAGCAGATCGACA -> GTCGTTAGCAGATCGACAC
GGTCTCATCATTTAGACTC -> GTCTCATCATTTAGACTCG
GGTGACTAGGTCGTTAGCA -> GTGACTAGGTCGTTAGCAG
GGTGCCGAATGCTCTTTGT -> GTGCCGAATGCTCTTTGTC
GGTGCGCCAGTAACCGATG -> GTGCGCCAGTAACCGATGG
GGTGCTAATTGTCCGTCAG -> GTGCTAATTGTCCGTCAGG
GGTGGCAGGGCCACTGTTA -> GTGGCAGGGCCACTGTTAT
GGTGGGAGGGGGGATAATG -> GTGGGAGGGGGGATAATGC
GGTGTAGACTGTCTGTCTA -> GTGTAGACTGTCTGTCTAG
GGTGTAGGCCGGGATTTTC -> GTGTAGGCCGGGATTTTCC
GGTGTAGTACGGACGCTGG -> GTGTAGTACGGACGCTGGA
GGTGTGATTAACCCGTTAA -> GTGTGATTAACCCGTTAAT
GGTGTTACGTCGCCCTGCA -> GTGTTACGTCGCCCTGCAC
GGTGTTGTCTGACGGAGAT -> GTGTTGTCTGACGGAGATA
GGTTCAACCTCAGAATCCC -> GTTCAACCTCAGAATCCCT
GGTTGATATCCGAGCAGTT -> GTTGATATCCGAGCAGTTC
GGTTTCATTGGAGTCAAGC -> GTTTCATTGGAGTCAAGCC
GGTTTGGTACTCCTTGCGG -> GTTTGGTACTCCTTGCGGA
GTAACCGATGGCTTTAGAT -> TAACCGATGGCTTTAGATT
GTAAGGGGACTTCCGCGCA -> TAAGGGGACTTCCGCGCAG
GTAATCCACTTGCCGTACC -> TAATCCACTTGCCGTACCG
GTAATTCCACCCGTCATGG -> TAATTCCACCCGTCATGGT
GTACATACCGGCAGCAGTA -> TACATACCGGCAGCAGTAT
GTACATGGTAGTGTGCAAT -> TACATGGTAGTGTGCAATG
GTACCGATCCGCTTTTGAT -> TACCGATCCGCTTTTGATA
GTACGAGACCGCTTGAATC -> TACGAGACCGCTTGAATCA
GTACGGACGCTGGAGGGCA -> TACGGACGCTGGAGGGCAA
GTACTCCGGGACACTTGTG -> TACTCCGGGACACTTGTGT
GTACTCCTTGCGGATCCGG -> TACTCCTTGCGGATCCGGT
GTAGAAACTTCGTCCCGAG -> TAGAAACTTCGTCCCGAGT
GTAGACTGTCTGTCTAGAG -> TAGACTGTCTGTCTAGAGT
GTAGATAACCTCAGAATCC -> TAGATAACCTCAGAATCCC
GTAGCCTTAAGTCAGACAA -> TAGCCTTAAGTCAGACAAT
GTAGCTCGTAGATAACCTC -> TAGCTCGTAGATAACCTCA
GTAGGCAGAGGATAGTCCT -> TAGGCAGAGGATAGTCCTA
GTAGGCCGGGATTTTCCCA -> TAGGCCGGGATTTTCCCAT
GTAGGTCCTTGCAGCTCCT -> TAGGTCCTTGCAGCTCCTA
GTAGTACGGACGCTGGAGG -> TAGTACGGACGCTGGAGGG
GTAGTGGGTTCAACCTCAG -> TAGTGGGTTCAACCTCAGA
GTAGTGTGCAATGTCTAAT -> TAGTGTGCAATGTCTAATC
GTAGTTCAAATTAGTGACA -> TAGTTCAAATTAGTGACAA
GTAGTTCAGAATGGTGTTA -> TAGTTCAGAATGGTGTTAC
GTATACCTTGTTATAGGGG -> TATACCTTGTTATAGGGGC
GTATATCACTACGAGACTG -> TATATCACTACGAGACTGG
GTATGACTCACAAGGAAGA -> TATGACTCACAAGGAAGAA
GTATTCTAGACATACCTCC -> TATTCTAGACATACCTCCG
GTATTCTTACTCAGGATGT -> TATTCTTACTCAGGATGTT
GTATTTACTGATGATCTGT -> TATTTACTGATGATCTGTT
GTATTTTCACTTTTTACTA -> TATTTTCACTTTTTACTAT
GTCAACACGTTGCCTGATC -> TCAACACGTTGCCTGATCT
GTCAACGACCTAACTCCAA -> TCAACGACCTAACTCCAAT
GTCAACTGCCGATCAGTGG -> TCAACTGCCGATCAGTGGC
GTCAAGCCACCGGGTCCTG -> TCAAGCCACCGGGTCCTGT
GTCACGCACGTCGAACCTC -> TCACGCACGTCGAACCTCA
GTCAGACAATGTGGCCCGG -> TCAGACAATGTGGCCCGGA
GTCAGGCGAGGCCCCGTCT -> TCAGGCGAGGCCCCGTCTA
GTCAGGTGGCAGGGCCACT -> TCAGGTGGCAGGGCCACTG
GTCATCGTGATATAAAAAA -> TCATCGTGATATAAAAAAT
GTCATGGTACTCCGGGACA -> TCATGGTACTCCGGGACAC
GTCATGGTCGCCCCATTAT -> TCATGGTCGCCCCATTATC
GTCCACGTTCTCTCTGGGC -> TCCACGTTCTCTCTGGGCC
GTCCAGCCGACTTCCAACA -> TCCAGCCGACTTCCAACAA
GTCCCGAGTAGGCAGAGGA -> TCCCGAGTAGGCAGAGGAT
GTCCCGCCTTTTACAGTCT -> TCCCGCCTTTTACAGTCTG
GTCCCTTCTAAGCCTACAG -> TCCCTTCTAAGCCTACAGC
GTCCGTCAGGCGAGGCCCC -> TCCGTCAGGCGAGGCCCCG
GTCCTAAAAGAGGGGAACA -> TCCTAAAAGAGGGGAACAT
GTCCTGCAGCCTGTAATTC -> TCCTGCAGCCTGTAATTCC
GTCCTGTTTAACGTCTGAG -> TCCTGTTTAACGTCTGAGT
GTCCTTGCAGCTCCTAAGA -> TCCTTGCAGCTCCTAAGAA
GTCGAACCTCAGAATCCCT -> TCGAACCTCAGAATCCCTA
GTCGAAGTGAAACACCTAG -> TCGAAGTGAAACACCTAGG
GTCGAATTTGTTTTTGGTG -> TCGAATTTGTTTTTGGTGT
GTCGAGCGAAACCATTAGC -> TCGAGCGAAACCATTAGCC
GTCGATGTGGGGTGTGATT -> TCGATGTGGGGTGTGATTA
GTCGCAGCTGCGTGTTGCA -> TCGCAGCTGCGTGTTGCAA
GTCGCCCCATTATCGCAGC -> TCGCCCCATTATCGCAGCT
GTCGCCCTGCACCCGCTCC -> TCGCCCTGCACCCGCTCCC
GTCGCGGAGCCTTCTAGAA -> TCGCGGAGCCTTCTAGAAG
GTCGCGTTTAGATCTGGTT -> TCGCGTTTAGATCTGGTTG
GTCGCTAGTAGCCTTAAGT -> TCGCTAGTAGCCTTAAGTC
GTCGGAAATCGAGTATTCT -> TCGGAAATCGAGTATTCTT
GTCGGCTTCGTACATACCG -> TCGGCTTCGTACATACCGG
GTCGGGTCGCTAGTAGCCT -> TCGGGTCGCTAGTAGCCTT
GTCGTTAGCAGATCGACAC -> TCGTTAGCAGATCGACACG
GTCGTTATCCCCTAATGTG -> TCGTTATCCCCTAATGTGT
GTCTAATCTGCTACTAAGA -> TCTAATCTGCTACTAAGAC
GTCTAGAGTCATGGTACTC -> TCTAGAGTCATGGTACTCC
GTCTATGAGCATTTGGACT -> TCTATGAGCATTTGGACTG
GTCTCATCATTTAGACTCG -> TCTCATCATTTAGACTCGT
GTCTCTCCTAATACACTCC -> TCTCTCCTAATACACTCCT
GTCTGACGGAGATAGTCGG -> TCTGACGGAGATAGTCGGG
GTCTGAGTAGGTCCTTGCA -> TCTGAGTAGGTCCTTGCAG
GTCTGCACTGTCGAATTTG -> TCTGCACTGTCGAATTTGT
GTCTGTCTAGAGTCATGGT -> TCTGTCTAGAGTCATGGTA
GTCTTAGAGATAGCGAGAA -> TCTTAGAGATAGCGAGAAT
GTGAAACACCTAGGCTGAA -> TGAAACACCTAGGCTGAAT
GTGACAAAGCGCGTTACAA -> TGACAAAGCGCGTTACAAC
GTGACTAGGTCGTTAGCAG -> TGACTAGGTCGTTAGCAGA
GTGAGGCGCCTCGGGAGAC -> TGAGGCGCCTCGGGAGACT
GTGATATAAAAAATAACAT -> TGATATAAAAAATAACATG
GTGATTAACCCGTTAATGG -> TGATTAACCCGTTAATGGA
GTGATTAACTCCGGGACAC -> TGATTAACTCCGGGACACT
GTGCAATGTCTAATCTGCT -> TGCAATGTCTAATCTGCTA
GTGCCGAATGCTCTTTGTC -> TGCCGAATGCTCTTTGTCA
GTGCGCCAGTAACCGATGG -> TGCGCCAGTAACCGATGGC
GTGCGGGGTGTTGTCTGAC -> TGCGGGGTGTTGTCTGACG
GTGCTAATTGTCCGTCAGG -> TGCTAATTGTCCGTCAGGC
GTGCTTGTCGGAAATCGAG -> TGCTTGTCGGAAATCGAGT
GTGGCAGGGCCACTGTTAT -> TGGCAGGGCCACTGTTATC
GTGGCCCGGATAGGGACGG -> TGGCCCGGATAGGGACGGA
GTGGCGAGTGTGTCAACGA -> TGGCGAGTGTGTCAACGAC
GTGGGAGGGGGGATAATGC -> TGGGAGGGGGGATAATGCA
GTGGGATCCGTGATTAACT -> TGGGATCCGTGATTAACTC
GTGGGCACATTCTTATAAT -> TGGGCACATTCTTATAATA
GTGGGGTGTGATTAACCCG -> TGGGGTGTGATTAACCCGT
GTGGGTTCAACCTCAGAAT -> TGGGTTCAACCTCAGAATC
GTGTAGACTGTCTGTCTAG -> TGTAGACTGTCTGTCTAGA
GTGTAGCTCGTAGATAACC -> TGTAGCTCGTAGATAACCT
GTGTAGGCCGGGATTTTCC -> TGTAGGCCGGGATTTTCCC
GTGTAGTACGGACGCTGGA -> TGTAGTACGGACGCTGGAG
GTGTAGTGGGTTCAACCTC -> TGTAGTGGGTTCAACCTCA
GTGTCAACGACCTAACTCC -> TGTCAACGACCTAACTCCA
GTGTCACGCACGTCGAACC -> TGTCACGCACGTCGAACCT
GTGTCTCTCCTAATACACT -> TGTCTCTCCTAATACACTC
GTGTGATTAACCCGTTAAT -> TGTGATTAACCCGTTAATG
GTGTGCAATGTCTAATCTG -> TGTGCAATGTCTAATCTGC
GTGTGCTTGTCGGAAATCG -> TGTGCTTGTCGGAAATCGA
GTGTGTAGTGGGTTCAACC -> TGTGTAGTGGGTTCAACCT
GTGTGTCAACGACCTAACT -> TGTGTCAACGACCTAACTC
GTGTTACGTCGCCCTGCAC -> TGTTACGTCGCCCTGCACC
GTGTTCCCGGCGGGCAACC -> TGTTCCCGGCGGGCAACCT
GTGTTGCAACGTTGATAGT -> TGTTGCAACGTTGATAGTC
GTGTTGTCTGACGGAGATA -> TGTTGTCTGACGGAGATAG
GTTAACGGTAATCCACTTG -> TTAACGGTAATCCACTTGC
GTTAATGGATCACCAGAAT -> TTAATGGATCACCAGAATG
GTTAATTCTAATGGACCTA -> TTAATTCTAATGGACCTAG
GTTACAACGTCCAGCCGAC -> TTACAACGTCCAGCCGACT
GTTACGTCGCCCTGCACCC -> TTACGTCGCCCTGCACCCG
GTTAGCAGATCGACACGAT -> TTAGCAGATCGACACGATA
GTTAGGACGGGTCGCGTTT -> TTAGGACGGGTCGCGTTTA
GTTATAGGAAGTTTAGGTG -> TTATAGGAAGTTTAGGTGT
GTTATAGGGGCCCCCGAGG -> TTATAGGGGCCCCCGAGGA
GTTATCCCCTAATGTGTCT -> TTATCCCCTAATGTGTCTC
GTTATCTTGGTGTAGGCCG -> TTATCTTGGTGTAGGCCGG
GTTCAAAGCGCGAAATGGT -> TTCAAAGCGCGAAATGGTA
GTTCAAATTAGTGACAAAG -> TTCAAATTAGTGACAAAGC
GTTCAACCTCAGAATCCCT -> TTCAACCTCAGAATCCCTA
GTTCAGAATGGTGTTACGT -> TTCAGAATGGTGTTACGTC
GTTCCCGGCGGGCAACCTC -> TTCCCGGCGGGCAACCTCA
GTTCCTATGCAGACCCGAA -> TTCCTATGCAGACCCGAAC
GTTCGCAACCCATAGGGCG -> TTCGCAACCCATAGGGCGG
GTTCTAACAATGTATATCA -> TTCTAACAATGTATATCAC
GTTCTCAAGTCGAAGTGAA -> TTCTCAAGTCGAAGTGAAA
GTTCTCTCTGGGCCTACGC -> TTCTCTCTGGGCCTACGCA
GTTGATAGTCCACGTTCTC -> TTGATAGTCCACGTTCTCT
GTTGATATCCGAGCAGTTC -> TTGATATCCGAGCAGTTCT
GTTGCAACGTTGATAGTCC -> TTGCAACGTTGATAGTCCA
GTTGCAGAATGATCCAAAG -> TTGCAGAATGATCCAAAGC
GTTGCCTGATCTCGCGATC -> TTGCCTGATCTCGCGATCG
GTTGTAGTTCAGAATGGTG -> TTGTAGTTCAGAATGGTGT
GTTGTCTGACGGAGATAGT -> TTGTCTGACGGAGATAGTC
GTTTAACGTCTGAGTAGGT -> TTTAACGTCTGAGTAGGTC
GTTTAGATCTGGTTGATAT -> TTTAGATCTGGTTGATATC
GTTTAGGTGTAGACTGTCT -> TTTAGGTGTAGACTGTCTG
GTTTCATTGGAGTCAAGCC -> TTTCATTGGAGTCAAGCCA
GTTTGAATGTATGACTCAC -> TTTGAATGTATGACTCACA
GTTTGGTACTCCTTGCGGA -> TTTGGTACTCCTTGCGGAT
GTTTTTGGTGTAGTACGGA -> TTTTTGGTGTAGTACGGAC
TAAAAAATAACATGGGTAT -> AAAAAATAACATGGGTATT
TAAAAGAGGGGAACATGAA -> AAAAGAGGGGAACATGAAA
TAAAGGTGCGCCAGTAACC -> AAAGGTGCGCCAGTAACCG
TAAATCCACATTTAGTCCT -> AAATCCACATTTAGTCCTG
TAAATGTTCAAAGCGCGAA -> AAATGTTCAAAGCGCGAAA
TAACAATGTATATCACTAC -> AACAATGTATATCACTACG
TAACAGCACCAACACACCC -> AACAGCACCAACACACCCC
TAACATCCCTAGCTTCTAG -> AACATCCCTAGCTTCTAGC
TAACATGGGTATTCTAGAC -> AACATGGGTATTCTAGACA
TAACCCAGTCTGCACTGTC -> AACCCAGTCTGCACTGTCG
TAACCCGTTAATGGATCAC -> AACCCGTTAATGGATCACC
TAACCGATGGCTTTAGATT -> AACCGATGGCTTTAGATTC
TAACCTCAGAATCCCTAGA -> AACCTCAGAATCCCTAGAC
TAACGGTAATCCACTTGCC -> AACGGTAATCCACTTGCCG
TAACGTCTGAGTAGGTCCT -> AACGTCTGAGTAGGTCCTT
TAACTCCAATCTGAAGAAG -> AACTCCAATCTGAAGAAGG
TAACTCCGGGACACTTGTG -> AACTCCGGGACACTTGTGT
TAACTTCTTCTAATTAGTT -> AACTTCTTCTAATTAGTTG
TAAGAACATGTCGATGTGG -> AAGAACATGTCGATGTGGG
TAAGAATACCCTACGGTGG -> AAGAATACCCTACGGTGGG
TAAGACTCACTCCGGGACA -> AAGACTCACTCCGGGACAC
TAAGCCTACAGCCTTATCC -> AAGCCTACAGCCTTATCCC
TAAGGGGACTTCCGCGCAG -> AAGGGGACTTCCGCGCAGA
TAAGGGGGGTCCCGCCTTT -> AAGGGGGGTCCCGCCTTTT
TAAGTCAGACAATGTGGCC -> AAGTCAGACAATGTGGCCC
TAATACACTCCTCCAGTAG -> AATACACTCCTCCAGTAGA
TAATAGTCCCTTCTAAGCC -> AATAGTCCCTTCTAAGCCT
TAATCCACTTGCCGTACCG -> AATCCACTTGCCGTACCGA
TAATCTGCTACTAAGACTC -> AATCTGCTACTAAGACTCA
TAATGCAGGAATCATAACA -> AATGCAGGAATCATAACAG
TAATGGACCTAGGGAGGGT -> AATGGACCTAGGGAGGGTG
TAATGGATCACCAGAATGA -> AATGGATCACCAGAATGAT
TAATGTGTCTCTCCTAATA -> AATGTGTCTCTCCTAATAC
TAATTAGTTGTAGTTCAGA -> AATTAGTTGTAGTTCAGAA
TAATTCCACCCGTCATGGT -> AATTCCACCCGTCATGGTC
TAATTCTAATGGACCTAGG -> AATTCTAATGGACCTAGGG
TAATTGTCCGTCAGGCGAG -> AATTGTCCGTCAGGCGAGG
TACAACGTCCAGCCGACTT -> ACAACGTCCAGCCGACTTC
TACACTCCTCCAGTAGAAA -> ACACTCCTCCAGTAGAAAC
TACAGCCTTATCCCGGACC -> ACAGCCTTATCCCGGACCT
TACATACCGGCAGCAGTAT -> ACATACCGGCAGCAGTATT
TACATCACAGAGGTTTGGT -> ACATCACAGAGGTTTGGTA
TACATGGTAGTGTGCAATG -> ACATGGTAGTGTGCAATGT
TACATGTTCGCAACCCATA -> ACATGTTCGCAACCCATAG
TACATTAACATCCCTAGCT -> ACATTAACATCCCTAGCTT
TACCCTACGGTGGGAGGGG -> ACCCTACGGTGGGAGGGGG
TACCGATCCGCTTTTGATA -> ACCGATCCGCTTTTGATAC
TACCGGCAGCAGTATTTAC -> ACCGGCAGCAGTATTTACT
TACCTCCGTTAGGACGGGT -> ACCTCCGTTAGGACGGGTC
TACCTTGTTATAGGGGCCC -> ACCTTGTTATAGGGGCCCC
TACGAGACCGCTTGAATCA -> ACGAGACCGCTTGAATCAA
TACGAGACTGGTACGAGAC -> ACGAGACTGGTACGAGACC
TACGCAGGATCTTGGGAAG -> ACGCAGGATCTTGGGAAGC
TACGCGGCAACCACGGTAT -> ACGCGGCAACCACGGTATA
TACGGACGCTGGAGGGCAA -> ACGGACGCTGGAGGGCAAG
TACGGTGGGAGGGGGGATA -> ACGGTGGGAGGGGGGATAA
TACGTCGCCCTGCACCCGC -> ACGTCGCCCTGCACCCGCT
TACTAAGACTCACTCCGGG -> ACTAAGACTCACTCCGGGA
TACTATGTAAGGGGACTTC -> ACTATGTAAGGGGACTTCC
TACTCAGGATGTTGCAGAA -> ACTCAGGATGTTGCAGAAT
TACTCCGGGACACTTGTGT -> ACTCCGGGACACTTGTGTT
TACTCCTTGCGGATCCGGT -> ACTCCTTGCGGATCCGGTC
TACTGATGATCTGTTATAG -> ACTGATGATCTGTTATAGG
TACTTTTGTCGAGCGAAAC -> ACTTTTGTCGAGCGAAACC
TAGAAACTTCGTCCCGAGT -> AGAAACTTCGTCCCGAGTA
TAGAAGATTTCCATAACCC -> AGAAGATTTCCATAACCCA
TAGAAGGAGTCAACTGCCG -> AGAAGGAGTCAACTGCCGA
TAGACAAGGGAGGCATAGT -> AGACAAGGGAGGCATAGTC
TAGACATACCTCCGTTAGG -> AGACATACCTCCGTTAGGA
TAGACCGTTAACGGTAATC -> AGACCGTTAACGGTAATCC
TAGACGGCCCGTGTGCTTG -> AGACGGCCCGTGTGCTTGT
TAGACTCGTCGTTATCCCC -> AGACTCGTCGTTATCCCCT
TAGACTGTCTGTCTAGAGT -> AGACTGTCTGTCTAGAGTC
TAGACTTTAGCATACATTA -> AGACTTTAGCATACATTAA
TAGAGATAGCGAGAATCAT -> AGAGATAGCGAGAATCATC
TAGAGTCATGGTACTCCGG -> AGAGTCATGGTACTCCGGG
TAGATAACCTCAGAATCCC -> AGATAACCTCAGAATCCCT
TAGATCTGGTTGATATCCG -> AGATCTGGTTGATATCCGA
TAGATTCCCACGTTCCTAT -> AGATTCCCACGTTCCTATG
TAGCAATCGTTAATTCTAA -> AGCAATCGTTAATTCTAAT
TAGCAGATCGACACGATAA -> AGCAGATCGACACGATAAA
TAGCATACATTAACATCCC -> AGCATACATTAACATCCCT
TAGCCCAGGTGACTAGGTC -> AGCCCAGGTGACTAGGTCG
TAGCCTTAAGTCAGACAAT -> AGCCTTAAGTCAGACAATG
TAGCGAGAATCATCGGCGA -> AGCGAGAATCATCGGCGAC
TAGCGGTCAACACGTTGCC -> AGCGGTCAACACGTTGCCT
TAGCTCGTAGATAACCTCA -> AGCTCGTAGATAACCTCAG
TAGCTTCTAGCAATCGTTA -> AGCTTCTAGCAATCGTTAA
TAGGAAGTTTAGGTGTAGA -> AGGAAGTTTAGGTGTAGAC
TAGGACGGGTCGCGTTTAG -> AGGACGGGTCGCGTTTAGA
TAGGCAGAGGATAGTCCTA -> AGGCAGAGGATAGTCCTAA
TAGGCCGGGATTTTCCCAT -> AGGCCGGGATTTTCCCATG
TAGGCTGAATAGAAGATTT -> AGGCTGAATAGAAGATTTC
TAGGGACGGAGTATTTTCA -> AGGGACGGAGTATTTTCAC
TAGGGAGGGTGCCGAATGC -> AGGGAGGGTGCCGAATGCT
TAGGGCGGCAGCTGCTTGG -> AGGGCGGCAGCTGCTTGGC
TAGGGGCCCCCGAGGATCC -> AGGGGCCCCCGAGGATCCA
TAGGTCCTTGCAGCTCCTA -> AGGTCCTTGCAGCTCCTAA
TAGGTCGTTAGCAGATCGA -> AGGTCGTTAGCAGATCGAC
TAGGTCTCATCATTTAGAC -> AGGTCTCATCATTTAGACT
TAGGTGTAGACTGTCTGTC -> AGGTGTAGACTGTCTGTCT
TAGTACGGACGCTGGAGGG -> AGTACGGACGCTGGAGGGC
TAGTAGCCTTAAGTCAGAC -> AGTAGCCTTAAGTCAGACA
TAGTCCACGTTCTCTCTGG -> AGTCCACGTTCTCTCTGGG
TAGTCCCTTCTAAGCCTAC -> AGTCCCTTCTAAGCCTACA
TAGTCCTAAAAGAGGGGAA -> AGTCCTAAAAGAGGGGAAC
TAGTCCTGCAGCCTGTAAT -> AGTCCTGCAGCCTGTAATT
TAGTCGCGGAGCCTTCTAG -> AGTCGCGGAGCCTTCTAGA
TAGTCGGGTCGCTAGTAGC -> AGTCGGGTCGCTAGTAGCC
TAGTGACAAAGCGCGTTAC -> AGTGACAAAGCGCGTTACA
TAGTGGGATCCGTGATTAA -> AGTGGGATCCGTGATTAAC
TAGTGGGTTCAACCTCAGA -> AGTGGGTTCAACCTCAGAA
TAGTGTGCAATGTCTAATC -> AGTGTGCAATGTCTAATCT
TAGTTCAAATTAGTGACAA -> AGTTCAAATTAGTGACAAA
TAGTTCAGAATGGTGTTAC -> AGTTCAGAATGGTGTTACG
TAGTTGTAGTTCAGAATGG -> AGTTGTAGTTCAGAATGGT
TATAAAAAATAACATGGGT -> ATAAAAAATAACATGGGTA
TATAATAGTCCCTTCTAAG -> ATAATAGTCCCTTCTAAGC
TATACCTTGTTATAGGGGC -> ATACCTTGTTATAGGGGCC
TATAGGAAGTTTAGGTGTA -> ATAGGAAGTTTAGGTGTAG
TATAGGGGCCCCCGAGGAT -> ATAGGGGCCCCCGAGGATC
TATATCACTACGAGACTGG -> ATATCACTACGAGACTGGT
TATCAAAAACTAAGGGGGG -> ATCAAAAACTAAGGGGGGT
TATCACTACGAGACTGGTA -> ATCACTACGAGACTGGTAC
TATCCCCTAATGTGTCTCT -> ATCCCCTAATGTGTCTCTC
TATCCCGGACCTTGCGTTT -> ATCCCGGACCTTGCGTTTG
TATCCGAGCAGTTCTCAAG -> ATCCGAGCAGTTCTCAAGT
TATCGCAGCTCCATGAATG -> ATCGCAGCTCCATGAATGT
TATCTTGGTGTAGGCCGGG -> ATCTTGGTGTAGGCCGGGA
TATGACTCACAAGGAAGAA -> ATGACTCACAAGGAAGAAA
TATGAGCATTTGGACTGAA -> ATGAGCATTTGGACTGAAT
TATGCAGACCCGAACCCTA -> ATGCAGACCCGAACCCTAA
TATGTAAGGGGACTTCCGC -> ATGTAAGGGGACTTCCGCG
TATTCTAGACATACCTCCG -> ATTCTAGACATACCTCCGT
TATTCTTACTCAGGATGTT -> ATTCTTACTCAGGATGTTG
TATTTACTGATGATCTGTT -> ATTTACTGATGATCTGTTA
TATTTTCACTTTTTACTAT -> ATTTTCACTTTTTACTATG
TCAAAAACTAAGGGGGGTC -> CAAAAACTAAGGGGGGTCC
TCAAACCATTACATCACAG -> CAAACCATTACATCACAGA
TCAAAGCGCGAAATGGTAG -> CAAAGCGCGAAATGGTAGT
TCAAATTAGTGACAAAGCG -> CAAATTAGTGACAAAGCGC
TCAACACGTTGCCTGATCT -> CAACACGTTGCCTGATCTC
TCAACCTCAGAATCCCTAG -> CAACCTCAGAATCCCTAGA
TCAACGACCTAACTCCAAT -> CAACGACCTAACTCCAATC
TCAACTGCCGATCAGTGGC -> CAACTGCCGATCAGTGGCG
TCAAGCCACCGGGTCCTGT -> CAAGCCACCGGGTCCTGTT
TCAAGTCGAAGTGAAACAC -> CAAGTCGAAGTGAAACACC
TCACAAGGAAGAAATCGTG -> CACAAGGAAGAAATCGTGA
TCACAGAGGTTTGGTACTC -> CACAGAGGTTTGGTACTCC
TCACCAGAATGATCCGCAG -> CACCAGAATGATCCGCAGG
TCACGCACGTCGAACCTCA -> CACGCACGTCGAACCTCAG
TCACTACGAGACTGGTACG -> CACTACGAGACTGGTACGA
TCACTCCGGGACACTTGTG -> CACTCCGGGACACTTGTGT
TCACTTTTTACTATGTAAG -> CACTTTTTACTATGTAAGG
TCAGAATCCCTAGACAAGG -> CAGAATCCCTAGACAAGGG
TCAGAATCCCTAGACCGTT -> CAGAATCCCTAGACCGTTA
TCAGAATCCCTAGACGGCC -> CAGAATCCCTAGACGGCCC
TCAGAATCCCTAGACTTTA -> CAGAATCCCTAGACTTTAG
TCAGAATGGTGTTACGTCG -> CAGAATGGTGTTACGTCGC
TCAGACAATGTGGCCCGGA -> CAGACAATGTGGCCCGGAT
TCAGGATGTTGCAGAATGA -> CAGGATGTTGCAGAATGAT
TCAGGCGAGGCCCCGTCTA -> CAGGCGAGGCCCCGTCTAT
TCAGGTGGCAGGGCCACTG -> CAGGTGGCAGGGCCACTGT
TCAGTGGCGAGTGTGTCAA -> CAGTGGCGAGTGTGTCAAC
TCATAACAGCACCAACACA -> CATAACAGCACCAACACAC
TCATAGCGGTCAACACGTT -> CATAGCGGTCAACACGTTG
TCATAGGTCTCATCATTTA -> CATAGGTCTCATCATTTAG
TCATCATTTAGACTCGTCG -> CATCATTTAGACTCGTCGT
TCATCGGCGACAACCATCG -> CATCGGCGACAACCATCGA
TCATCGTGATATAAAAAAT -> CATCGTGATATAAAAAATA
TCATGGTACTCCGGGACAC -> CATGGTACTCCGGGACACT
TCATGGTCGCCCCATTATC -> CATGGTCGCCCCATTATCG
TCATTGGAGTCAAGCCACC -> CATTGGAGTCAAGCCACCG
TCATTTAGACTCGTCGTTA -> CATTTAGACTCGTCGTTAT
TCCAAAGCGGGCTGCTGTC -> CCAAAGCGGGCTGCTGTCT
TCCAACAAAGCCGAATCAT -> CCAACAAAGCCGAATCATA
TCCAATCTGAAGAAGGTTT -> CCAATCTGAAGAAGGTTTC
TCCACATTTAGTCCTGCAG -> CCACATTTAGTCCTGCAGC
TCCACCCGTCATGGTCGCC -> CCACCCGTCATGGTCGCCC
TCCACGTTCTCTCTGGGCC -> CCACGTTCTCTCTGGGCCT
TCCACTAAGAACATGTCGA -> CCACTAAGAACATGTCGAT
TCCACTTGCCGTACCGATC -> CCACTTGCCGTACCGATCC
TCCAGCCGACTTCCAACAA -> CCAGCCGACTTCCAACAAA
TCCAGTAGAAACTTCGTCC -> CCAGTAGAAACTTCGTCCC
TCCATAACCCAGTCTGCAC -> CCATAACCCAGTCTGCACT
TCCATGAATGTTCTAACAA -> CCATGAATGTTCTAACAAT
TCCCACGTTCCTATGCAGA -> CCCACGTTCCTATGCAGAC
TCCCATGGCCGCCGGTGCT -> CCCATGGCCGCCGGTGCTA
TCCCCTAATGTGTCTCTCC -> CCCCTAATGTGTCTCTCCT
TCCCGAGTAGGCAGAGGAT -> CCCGAGTAGGCAGAGGATA
TCCCGCCTTTTACAGTCTG -> CCCGCCTTTTACAGTCTGC
TCCCGGACCTTGCGTTTGA -> CCCGGACCTTGCGTTTGAA
TCCCGGCGGGCAACCTCAG -> CCCGGCGGGCAACCTCAGA
TCCCTAGACAAGGGAGGCA -> CCCTAGACAAGGGAGGCAT
TCCCTAGACCGTTAACGGT -> CCCTAGACCGTTAACGGTA
TCCCTAGACGGCCCGTGTG -> CCCTAGACGGCCCGTGTGC
TCCCTAGACTTTAGCATAC -> CCCTAGACTTTAGCATACA
TCCCTAGCTTCTAGCAATC -> CCCTAGCTTCTAGCAATCG
TCCCTCTTAGTGGGATCCG -> CCCTCTTAGTGGGATCCGT
TCCCTTCTAAGCCTACAGC -> CCCTTCTAAGCCTACAGCC
TCCGAGCAGTTCTCAAGTC -> CCGAGCAGTTCTCAAGTCG
TCCGCAGGAGCCTGCGTGG -> CCGCAGGAGCCTGCGTGGG
TCCGCGCAGAATGCGGCCT -> CCGCGCAGAATGCGGCCTA
TCCGCTTTTGATACATGTT -> CCGCTTTTGATACATGTTC
TCCGGGACACTTGTGTAGC -> CCGGGACACTTGTGTAGCT
TCCGGGACACTTGTGTCAC -> CCGGGACACTTGTGTCACG
TCCGGGACACTTGTGTGTA -> CCGGGACACTTGTGTGTAG
TCCGGGACACTTGTGTTCC -> CCGGGACACTTGTGTTCCC
TCCGGTCATCGTGATATAA -> CCGGTCATCGTGATATAAA
TCCGTCAGGCGAGGCCCCG -> CCGTCAGGCGAGGCCCCGT
TCCGTGATTAACTCCGGGA -> CCGTGATTAACTCCGGGAC
TCCGTTAGGACGGGTCGCG -> CCGTTAGGACGGGTCGCGT
TCCTAAAAGAGGGGAACAT -> CCTAAAAGAGGGGAACATG
TCCTAACTTCTTCTAATTA -> CCTAACTTCTTCTAATTAG
TCCTAAGAATACCCTACGG -> CCTAAGAATACCCTACGGT
TCCTAATACACTCCTCCAG -> CCTAATACACTCCTCCAGT
TCCTATGCAGACCCGAACC -> CCTATGCAGACCCGAACCC
TCCTCCAGTAGAAACTTCG -> CCTCCAGTAGAAACTTCGT
TCCTGCAGCCTGTAATTCC -> CCTGCAGCCTGTAATTCCA
TCCTGTTTAACGTCTGAGT -> CCTGTTTAACGTCTGAGTA
TCCTTGCAGCTCCTAAGAA -> CCTTGCAGCTCCTAAGAAT
TCCTTGCGGATCCGGTCAT -> CCTTGCGGATCCGGTCATC
TCGAACCTCAGAATCCCTA -> CGAACCTCAGAATCCCTAG
TCGAAGGTCGCAGCTGCGT -> CGAAGGTCGCAGCTGCGTG
TCGAAGTGAAACACCTAGG -> CGAAGTGAAACACCTAGGC
TCGAATTTGTTTTTGGTGT -> CGAATTTGTTTTTGGTGTA
TCGACACGATAAAGGTGCG -> CGACACGATAAAGGTGCGC
TCGAGCGAAACCATTAGCC -> CGAGCGAAACCATTAGCCC
TCGAGTATTCTTACTCAGG -> CGAGTATTCTTACTCAGGA
TCGATGTGCGGGGTGTTGT -> CGATGTGCGGGGTGTTGTC
TCGATGTGGGGTGTGATTA -> CGATGTGGGGTGTGATTAA
TCGCAACCCATAGGGCGGC -> CGCAACCCATAGGGCGGCA
TCGCAGCTCCATGAATGTT -> CGCAGCTCCATGAATGTTC
TCGCAGCTGCGTGTTGCAA -> CGCAGCTGCGTGTTGCAAC
TCGCCCCATTATCGCAGCT -> CGCCCCATTATCGCAGCTC
TCGCCCTGCACCCGCTCCC -> CGCCCTGCACCCGCTCCCT
TCGCGATCGATGTGCGGGG -> CGCGATCGATGTGCGGGGT
TCGCGGAGCCTTCTAGAAG -> CGCGGAGCCTTCTAGAAGG
TCGCGTTTAGATCTGGTTG -> CGCGTTTAGATCTGGTTGA
TCGCTAGTAGCCTTAAGTC -> CGCTAGTAGCCTTAAGTCA
TCGGAAATCGAGTATTCTT -> CGGAAATCGAGTATTCTTA
TCGGCGACAACCATCGAAG -> CGGCGACAACCATCGAAGG
TCGGCTTCGTACATACCGG -> CGGCTTCGTACATACCGGC
TCGGGAGACTCCGGGACAC -> CGGGAGACTCCGGGACACT
TCGGGTCGCTAGTAGCCTT -> CGGGTCGCTAGTAGCCTTA
TCGTACATACCGGCAGCAG -> CGTACATACCGGCAGCAGT
TCGTAGATAACCTCAGAAT -> CGTAGATAACCTCAGAATC
TCGTCCCGAGTAGGCAGAG -> CGTCCCGAGTAGGCAGAGG
TCGTCGTTATCCCCTAATG -> CGTCGTTATCCCCTAATGT
TCGTGAGGCGCCTCGGGAG -> CGTGAGGCGCCTCGGGAGA
TCGTGATATAAAAAATAAC -> CGTGATATAAAAAATAACA
TCGTTAATTCTAATGGACC -> CGTTAATTCTAATGGACCT
TCGTTAGCAGATCGACACG -> CGTTAGCAGATCGACACGA
TCGTTATCCCCTAATGTGT -> CGTTATCCCCTAATGTGTC
TCTAACAATGTATATCACT -> CTAACAATGTATATCACTA
TCTAAGCCTACAGCCTTAT -> CTAAGCCTACAGCCTTATC
TCTAATCTGCTACTAAGAC -> CTAATCTGCTACTAAGACT
TCTAATGGACCTAGGGAGG -> CTAATGGACCTAGGGAGGG
TCTAATTAGTTGTAGTTCA -> CTAATTAGTTGTAGTTCAG
TCTAGAAGGAGTCAACTGC -> CTAGAAGGAGTCAACTGCC
TCTAGACATACCTCCGTTA -> CTAGACATACCTCCGTTAG
TCTAGAGTCATGGTACTCC -> CTAGAGTCATGGTACTCCG
TCTAGCAATCGTTAATTCT -> CTAGCAATCGTTAATTCTA
TCTATGAGCATTTGGACTG -> CTATGAGCATTTGGACTGA
TCTCAAGTCGAAGTGAAAC -> CTCAAGTCGAAGTGAAACA
TCTCATCATTTAGACTCGT -> CTCATCATTTAGACTCGTC
TCTCCTAATACACTCCTCC -> CTCCTAATACACTCCTCCA
TCTCGCGATCGATGTGCGG -> CTCGCGATCGATGTGCGGG
TCTCTCCTAATACACTCCT -> CTCTCCTAATACACTCCTC
TCTCTCTGGGCCTACGCAG -> CTCTCTGGGCCTACGCAGG
TCTCTGGGCCTACGCAGGA -> CTCTGGGCCTACGCAGGAT
TCTGAAGAAGGTTTCATTG -> CTGAAGAAGGTTTCATTGG
TCTGACGGAGATAGTCGGG -> CTGACGGAGATAGTCGGGT
TCTGAGTAGGTCCTTGCAG -> CTGAGTAGGTCCTTGCAGC
TCTGCACTGTCGAATTTGT -> CTGCACTGTCGAATTTGTT
TCTGCTACTAAGACTCACT -> CTGCTACTAAGACTCACTC
TCTGGGCCTACGCAGGATC -> CTGGGCCTACGCAGGATCT
TCTGGGGAACTGGCTATCA -> CTGGGGAACTGGCTATCAA
TCTGGTTGATATCCGAGCA -> CTGGTTGATATCCGAGCAG
TCTGTCTAGAGTCATGGTA -> CTGTCTAGAGTCATGGTAC
TCTGTTATAGGAAGTTTAG -> CTGTTATAGGAAGTTTAGG
TCTTACTCAGGATGTTGCA -> CTTACTCAGGATGTTGCAG
TCTTAGAGATAGCGAGAAT -> CTTAGAGATAGCGAGAATC
TCTTAGTGGGATCCGTGAT -> CTTAGTGGGATCCGTGATT
TCTTATAATAGTCCCTTCT -> CTTATAATAGTCCCTTCTA
TCTTCTAATTAGTTGTAGT -> CTTCTAATTAGTTGTAGTT
TCTTGGGAAGCCGTACATG -> CTTGGGAAGCCGTACATGG
TCTTGGTGTAGGCCGGGAT -> CTTGGTGTAGGCCGGGATT
TCTTTGTCAGGTGGCAGGG -> CTTTGTCAGGTGGCAGGGC
TGAAACACCTAGGCTGAAT -> GAAACACCTAGGCTGAATA
TGAAACGAATTCATAGCGG -> GAAACGAATTCATAGCGGT
TGAAGAAGGTTTCATTGGA -> GAAGAAGGTTTCATTGGAG
TGAATACTTTTGTCGAGCG -> GAATACTTTTGTCGAGCGA
TGAATAGAAGATTTCCATA -> GAATAGAAGATTTCCATAA
TGAATCAAACCATTACATC -> GAATCAAACCATTACATCA
TGAATGTATGACTCACAAG -> GAATGTATGACTCACAAGG
TGAATGTTCTAACAATGTA -> GAATGTTCTAACAATGTAT
TGACAAAGCGCGTTACAAC -> GACAAAGCGCGTTACAACG
TGACGGAGATAGTCGGGTC -> GACGGAGATAGTCGGGTCG
TGACTAGGTCGTTAGCAGA -> GACTAGGTCGTTAGCAGAT
TGACTCACAAGGAAGAAAT -> GACTCACAAGGAAGAAATC
TGAGCATTTGGACTGAATA -> GAGCATTTGGACTGAATAC
TGAGGCGCCTCGGGAGACT -> GAGGCGCCTCGGGAGACTC
TGAGTAGGTCCTTGCAGCT -> GAGTAGGTCCTTGCAGCTC
TGATACATGTTCGCAACCC -> GATACATGTTCGCAACCCA
TGATAGTCCACGTTCTCTC -> GATAGTCCACGTTCTCTCT
TGATATAAAAAATAACATG -> GATATAAAAAATAACATGG
TGATATCCGAGCAGTTCTC -> GATATCCGAGCAGTTCTCA
TGATCCAAAGCGGGCTGCT -> GATCCAAAGCGGGCTGCTG
TGATCCGCAGGAGCCTGCG -> GATCCGCAGGAGCCTGCGT
TGATCTCGCGATCGATGTG -> GATCTCGCGATCGATGTGC
TGATCTGTTATAGGAAGTT -> GATCTGTTATAGGAAGTTT
TGATGATCTGTTATAGGAA -> GATGATCTGTTATAGGAAG
TGATTAACCCGTTAATGGA -> GATTAACCCGTTAATGGAT
TGATTAACTCCGGGACACT -> GATTAACTCCGGGACACTT
TGCAACGTTGATAGTCCAC -> GCAACGTTGATAGTCCACG
TGCAATGTCTAATCTGCTA -> GCAATGTCTAATCTGCTAC
TGCACCCGCTCCCTCTTAG -> GCACCCGCTCCCTCTTAGT
TGCACTGTCGAATTTGTTT -> GCACTGTCGAATTTGTTTT
TGCAGAATGATCCAAAGCG -> GCAGAATGATCCAAAGCGG
TGCAGACCCGAACCCTAAA -> GCAGACCCGAACCCTAAAT
TGCAGCCTGTAATTCCACC -> GCAGCCTGTAATTCCACCC
TGCAGCTCCTAAGAATACC -> GCAGCTCCTAAGAATACCC
TGCAGGAATCATAACAGCA -> GCAGGAATCATAACAGCAC
TGCCGAATGCTCTTTGTCA -> GCCGAATGCTCTTTGTCAG
TGCCGATCAGTGGCGAGTG -> GCCGATCAGTGGCGAGTGT
TGCCGTACCGATCCGCTTT -> GCCGTACCGATCCGCTTTT
TGCCTGATCTCGCGATCGA -> GCCTGATCTCGCGATCGAT
TGCGCCAGTAACCGATGGC -> GCGCCAGTAACCGATGGCT
TGCGGATCCGGTCATCGTG -> GCGGATCCGGTCATCGTGA
TGCGGCCTAAATCCACATT -> GCGGCCTAAATCCACATTT
TGCGGGGTGTTGTCTGACG -> GCGGGGTGTTGTCTGACGG
TGCGTGGGCACATTCTTAT -> GCGTGGGCACATTCTTATA
TGCGTGTTGCAACGTTGAT -> GCGTGTTGCAACGTTGATA
TGCGTTTGAATGTATGACT -> GCGTTTGAATGTATGACTC
TGCTAATTGTCCGTCAGGC -> GCTAATTGTCCGTCAGGCG
TGCTACTAAGACTCACTCC -> GCTACTAAGACTCACTCCG
TGCTCTTTGTCAGGTGGCA -> GCTCTTTGTCAGGTGGCAG
TGCTGTCTTAGAGATAGCG -> GCTGTCTTAGAGATAGCGA
TGCTTGGCATCCTAACTTC -> GCTTGGCATCCTAACTTCT
TGCTTGTCGGAAATCGAGT -> GCTTGTCGGAAATCGAGTA
TGGACCTAGGGAGGGTGCC -> GGACCTAGGGAGGGTGCCG
TGGACTGAATACTTTTGTC -> GGACTGAATACTTTTGTCG
TGGAGGGCAAGATACGCGG -> GGAGGGCAAGATACGCGGC
TGGAGTCAAGCCACCGGGT -> GGAGTCAAGCCACCGGGTC
TGGATCACCAGAATGATCC -> GGATCACCAGAATGATCCG
TGGCAGGGCCACTGTTATC -> GGCAGGGCCACTGTTATCT
TGGCATCCTAACTTCTTCT -> GGCATCCTAACTTCTTCTA
TGGCCCGGATAGGGACGGA -> GGCCCGGATAGGGACGGAG
TGGCCGCCGGTGCTAATTG -> GGCCGCCGGTGCTAATTGT
TGGCGAGTGTGTCAACGAC -> GGCGAGTGTGTCAACGACC
TGGCTATCAAAAACTAAGG -> GGCTATCAAAAACTAAGGG
TGGCTTTAGATTCCCACGT -> GGCTTTAGATTCCCACGTT
TGGGAAGCCGTACATGGTA -> GGGAAGCCGTACATGGTAG
TGGGAGGGGGGATAATGCA -> GGGAGGGGGGATAATGCAG
TGGGATCCGTGATTAACTC -> GGGATCCGTGATTAACTCC
TGGGCACATTCTTATAATA -> GGGCACATTCTTATAATAG
TGGGCCTACGCAGGATCTT -> GGGCCTACGCAGGATCTTG
TGGGGAACTGGCTATCAAA -> GGGGAACTGGCTATCAAAA
TGGGGTGTGATTAACCCGT -> GGGGTGTGATTAACCCGTT
TGGGTATTCTAGACATACC -> GGGTATTCTAGACATACCT
TGGGTTCAACCTCAGAATC -> GGGTTCAACCTCAGAATCC
TGGTACGAGACCGCTTGAA -> GGTACGAGACCGCTTGAAT
TGGTACTCCGGGACACTTG -> GGTACTCCGGGACACTTGT
TGGTACTCCTTGCGGATCC -> GGTACTCCTTGCGGATCCG
TGGTAGTGTGCAATGTCTA -> GGTAGTGTGCAATGTCTAA
TGGTAGTTCAAATTAGTGA -> GGTAGTTCAAATTAGTGAC
TGGTCGCCCCATTATCGCA -> GGTCGCCCCATTATCGCAG
TGGTGTAGGCCGGGATTTT -> GGTGTAGGCCGGGATTTTC
TGGTGTAGTACGGACGCTG -> GGTGTAGTACGGACGCTGG
TGGTGTTACGTCGCCCTGC -> GGTGTTACGTCGCCCTGCA
TGGTTGATATCCGAGCAGT -> GGTTGATATCCGAGCAGTT
TGTAAGGGGACTTCCGCGC -> GTAAGGGGACTTCCGCGCA
TGTAATTCCACCCGTCATG -> GTAATTCCACCCGTCATGG
TGTAGACTGTCTGTCTAGA -> GTAGACTGTCTGTCTAGAG
TGTAGCTCGTAGATAACCT -> GTAGCTCGTAGATAACCTC
TGTAGGCCGGGATTTTCCC -> GTAGGCCGGGATTTTCCCA
TGTAGTACGGACGCTGGAG -> GTAGTACGGACGCTGGAGG
TGTAGTGGGTTCAACCTCA -> GTAGTGGGTTCAACCTCAG
TGTAGTTCAGAATGGTGTT -> GTAGTTCAGAATGGTGTTA
TGTATATCACTACGAGACT -> GTATATCACTACGAGACTG
TGTATGACTCACAAGGAAG -> GTATGACTCACAAGGAAGA
TGTCAACGACCTAACTCCA -> GTCAACGACCTAACTCCAA
TGTCACGCACGTCGAACCT -> GTCACGCACGTCGAACCTC
TGTCAGGTGGCAGGGCCAC -> GTCAGGTGGCAGGGCCACT
TGTCCGTCAGGCGAGGCCC -> GTCCGTCAGGCGAGGCCCC
TGTCGAATTTGTTTTTGGT -> GTCGAATTTGTTTTTGGTG
TGTCGAGCGAAACCATTAG -> GTCGAGCGAAACCATTAGC
TGTCGATGTGGGGTGTGAT -> GTCGATGTGGGGTGTGATT
TGTCGGAAATCGAGTATTC -> GTCGGAAATCGAGTATTCT
TGTCTAATCTGCTACTAAG -> GTCTAATCTGCTACTAAGA
TGTCTAGAGTCATGGTACT -> GTCTAGAGTCATGGTACTC
TGTCTCTCCTAATACACTC -> GTCTCTCCTAATACACTCC
TGTCTGACGGAGATAGTCG -> GTCTGACGGAGATAGTCGG
TGTCTGTCTAGAGTCATGG -> GTCTGTCTAGAGTCATGGT
TGTCTTAGAGATAGCGAGA -> GTCTTAGAGATAGCGAGAA
TGTGATTAACCCGTTAATG -> GTGATTAACCCGTTAATGG
TGTGCAATGTCTAATCTGC -> GTGCAATGTCTAATCTGCT
TGTGCGGGGTGTTGTCTGA -> GTGCGGGGTGTTGTCTGAC
TGTGCTTGTCGGAAATCGA -> GTGCTTGTCGGAAATCGAG
TGTGGCCCGGATAGGGACG -> GTGGCCCGGATAGGGACGG
TGTGGGGTGTGATTAACCC -> GTGGGGTGTGATTAACCCG
TGTGTAGCTCGTAGATAAC -> GTGTAGCTCGTAGATAACC
TGTGTAGTGGGTTCAACCT -> GTGTAGTGGGTTCAACCTC
TGTGTCAACGACCTAACTC -> GTGTCAACGACCTAACTCC
TGTGTCACGCACGTCGAAC -> GTGTCACGCACGTCGAACC
TGTGTCTCTCCTAATACAC -> GTGTCTCTCCTAATACACT
TGTGTGTAGTGGGTTCAAC -> GTGTGTAGTGGGTTCAACC
TGTGTTCCCGGCGGGCAAC -> GTGTTCCCGGCGGGCAACC
TGTTACGTCGCCCTGCACC -> GTTACGTCGCCCTGCACCC
TGTTATAGGAAGTTTAGGT -> GTTATAGGAAGTTTAGGTG
TGTTATAGGGGCCCCCGAG -> GTTATAGGGGCCCCCGAGG
TGTTATCTTGGTGTAGGCC -> GTTATCTTGGTGTAGGCCG
TGTTCAAAGCGCGAAATGG -> GTTCAAAGCGCGAAATGGT
TGTTCCCGGCGGGCAACCT -> GTTCCCGGCGGGCAACCTC
TGTTCGCAACCCATAGGGC -> GTTCGCAACCCATAGGGCG
TGTTCTAACAATGTATATC -> GTTCTAACAATGTATATCA
TGTTGCAACGTTGATAGTC -> GTTGCAACGTTGATAGTCC
TGTTGCAGAATGATCCAAA -> GTTGCAGAATGATCCAAAG
TGTTGTCTGACGGAGATAG -> GTTGTCTGACGGAGATAGT
TGTTTAACGTCTGAGTAGG -> GTTTAACGTCTGAGTAGGT
TGTTTTTGGTGTAGTACGG -> GTTTTTGGTGTAGTACGGA
TTAACATCCCTAGCTTCTA -> TAACATCCCTAGCTTCTAG
TTAACCCGTTAATGGATCA -> TAACCCGTTAATGGATCAC
TTAACGGTAATCCACTTGC -> TAACGGTAATCCACTTGCC
TTAACGTCTGAGTAGGTCC -> TAACGTCTGAGTAGGTCCT
TTAACTCCGGGACACTTGT -> TAACTCCGGGACACTTGTG
TTAAGTCAGACAATGTGGC -> TAAGTCAGACAATGTGGCC
TTAATGGATCACCAGAATG -> TAATGGATCACCAGAATGA
TTAATTCTAATGGACCTAG -> TAATTCTAATGGACCTAGG
TTACAACGTCCAGCCGACT -> TACAACGTCCAGCCGACTT
TTACATCACAGAGGTTTGG -> TACATCACAGAGGTTTGGT
TTACGTCGCCCTGCACCCG -> TACGTCGCCCTGCACCCGC
TTACTATGTAAGGGGACTT -> TACTATGTAAGGGGACTTC
TTACTCAGGATGTTGCAGA -> TACTCAGGATGTTGCAGAA
TTACTGATGATCTGTTATA -> TACTGATGATCTGTTATAG
TTAGACTCGTCGTTATCCC -> TAGACTCGTCGTTATCCCC
TTAGAGATAGCGAGAATCA -> TAGAGATAGCGAGAATCAT
TTAGATCTGGTTGATATCC -> TAGATCTGGTTGATATCCG
TTAGATTCCCACGTTCCTA -> TAGATTCCCACGTTCCTAT
TTAGCAGATCGACACGATA -> TAGCAGATCGACACGATAA
TTAGCATACATTAACATCC -> TAGCATACATTAACATCCC
TTAGCCCAGGTGACTAGGT -> TAGCCCAGGTGACTAGGTC
TTAGGACGGGTCGCGTTTA -> TAGGACGGGTCGCGTTTAG
TTAGGTGTAGACTGTCTGT -> TAGGTGTAGACTGTCTGTC
TTAGTCCTGCAGCCTGTAA -> TAGTCCTGCAGCCTGTAAT
TTAGTGACAAAGCGCGTTA -> TAGTGACAAAGCGCGTTAC
TTAGTGGGATCCGTGATTA -> TAGTGGGATCCGTGATTAA
TTAGTTGTAGTTCAGAATG -> TAGTTGTAGTTCAGAATGG
TTATAATAGTCCCTTCTAA -> TATAATAGTCCCTTCTAAG
TTATAGGAAGTTTAGGTGT -> TATAGGAAGTTTAGGTGTA
TTATAGGGGCCCCCGAGGA -> TATAGGGGCCCCCGAGGAT
TTATCCCCTAATGTGTCTC -> TATCCCCTAATGTGTCTCT
TTATCCCGGACCTTGCGTT -> TATCCCGGACCTTGCGTTT
TTATCGCAGCTCCATGAAT -> TATCGCAGCTCCATGAATG
TTATCTTGGTGTAGGCCGG -> TATCTTGGTGTAGGCCGGG
TTCAAAGCGCGAAATGGTA -> TCAAAGCGCGAAATGGTAG
TTCAAATTAGTGACAAAGC -> TCAAATTAGTGACAAAGCG
TTCAACCTCAGAATCCCTA -> TCAACCTCAGAATCCCTAG
TTCACTTTTTACTATGTAA -> TCACTTTTTACTATGTAAG
TTCAGAATGGTGTTACGTC -> TCAGAATGGTGTTACGTCG
TTCATAGCGGTCAACACGT -> TCATAGCGGTCAACACGTT
TTCATTGGAGTCAAGCCAC -> TCATTGGAGTCAAGCCACC
TTCCAACAAAGCCGAATCA -> TCCAACAAAGCCGAATCAT
TTCCACCCGTCATGGTCGC -> TCCACCCGTCATGGTCGCC
TTCCATAACCCAGTCTGCA -> TCCATAACCCAGTCTGCAC
TTCCCACGTTCCTATGCAG -> TCCCACGTTCCTATGCAGA
TTCCCATGGCCGCCGGTGC -> TCCCATGGCCGCCGGTGCT
TTCCCGGCGGGCAACCTCA -> TCCCGGCGGGCAACCTCAG
TTCCGCGCAGAATGCGGCC -> TCCGCGCAGAATGCGGCCT
TTCCTATGCAGACCCGAAC -> TCCTATGCAGACCCGAACC
TTCGCAACCCATAGGGCGG -> TCGCAACCCATAGGGCGGC
TTCGTACATACCGGCAGCA -> TCGTACATACCGGCAGCAG
TTCGTCCCGAGTAGGCAGA -> TCGTCCCGAGTAGGCAGAG
TTCTAACAATGTATATCAC -> TCTAACAATGTATATCACT
TTCTAAGCCTACAGCCTTA -> TCTAAGCCTACAGCCTTAT
TTCTAATGGACCTAGGGAG -> TCTAATGGACCTAGGGAGG
TTCTAATTAGTTGTAGTTC -> TCTAATTAGTTGTAGTTCA
TTCTAGAAGGAGTCAACTG -> TCTAGAAGGAGTCAACTGC
TTCTAGACATACCTCCGTT -> TCTAGACATACCTCCGTTA
TTCTAGCAATCGTTAATTC -> TCTAGCAATCGTTAATTCT
TTCTCAAGTCGAAGTGAAA -> TCTCAAGTCGAAGTGAAAC
TTCTCTCTGGGCCTACGCA -> TCTCTCTGGGCCTACGCAG
TTCTGGGGAACTGGCTATC -> TCTGGGGAACTGGCTATCA
TTCTTACTCAGGATGTTGC -> TCTTACTCAGGATGTTGCA
TTCTTATAATAGTCCCTTC -> TCTTATAATAGTCCCTTCT
TTCTTCTAATTAGTTGTAG -> TCTTCTAATTAGTTGTAGT
TTGAATCAAACCATTACAT -> TGAATCAAACCATTACATC
TTGAATGTATGACTCACAA -> TGAATGTATGACTCACAAG
TTGATACATGTTCGCAACC -> TGATACATGTTCGCAACCC
TTGATAGTCCACGTTCTCT -> TGATAGTCCACGTTCTCTC
TTGATATCCGAGCAGTTCT -> TGATATCCGAGCAGTTCTC
TTGCAACGTTGATAGTCCA -> TGCAACGTTGATAGTCCAC
TTGCAGAATGATCCAAAGC -> TGCAGAATGATCCAAAGCG
TTGCAGCTCCTAAGAATAC -> TGCAGCTCCTAAGAATACC
TTGCCGTACCGATCCGCTT -> TGCCGTACCGATCCGCTTT
TTGCCTGATCTCGCGATCG -> TGCCTGATCTCGCGATCGA
TTGCGGATCCGGTCATCGT -> TGCGGATCCGGTCATCGTG
TTGCGTTTGAATGTATGAC -> TGCGTTTGAATGTATGACT
TTGGACTGAATACTTTTGT -> TGGACTGAATACTTTTGTC
TTGGAGTCAAGCCACCGGG -> TGGAGTCAAGCCACCGGGT
TTGGCATCCTAACTTCTTC -> TGGCATCCTAACTTCTTCT
TTGGGAAGCCGTACATGGT -> TGGGAAGCCGTACATGGTA
TTGGTACTCCTTGCGGATC -> TGGTACTCCTTGCGGATCC
TTGGTGTAGGCCGGGATTT -> TGGTGTAGGCCGGGATTTT
TTGGTGTAGTACGGACGCT -> TGGTGTAGTACGGACGCTG
TTGTAGTTCAGAATGGTGT -> TGTAGTTCAGAATGGTGTT
TTGTCAGGTGGCAGGGCCA -> TGTCAGGTGGCAGGGCCAC
TTGTCCGTCAGGCGAGGCC -> TGTCCGTCAGGCGAGGCCC
TTGTCGAGCGAAACCATTA -> TGTCGAGCGAAACCATTAG
TTGTCGGAAATCGAGTATT -> TGTCGGAAATCGAGTATTC
TTGTCTGACGGAGATAGTC -> TGTCTGACGGAGATAGTCG
TTGTGTAGCTCGTAGATAA -> TGTGTAGCTCGTAGATAAC
TTGTGTCACGCACGTCGAA -> TGTGTCACGCACGTCGAAC
TTGTGTGTAGTGGGTTCAA -> TGTGTGTAGTGGGTTCAAC
TTGTGTTCCCGGCGGGCAA -> TGTGTTCCCGGCGGGCAAC
TTGTTATAGGGGCCCCCGA -> TGTTATAGGGGCCCCCGAG
TTGTTTTTGGTGTAGTACG -> TGTTTTTGGTGTAGTACGG
TTTAACGTCTGAGTAGGTC -> TTAACGTCTGAGTAGGTCC
TTTACTATGTAAGGGGACT -> TTACTATGTAAGGGGACTT
TTTACTGATGATCTGTTAT -> TTACTGATGATCTGTTATA
TTTAGACTCGTCGTTATCC -> TTAGACTCGTCGTTATCCC
TTTAGATCTGGTTGATATC -> TTAGATCTGGTTGATATCC
TTTAGATTCCCACGTTCCT -> TTAGATTCCCACGTTCCTA
TTTAGCATACATTAACATC -> TTAGCATACATTAACATCC
TTTAGGTGTAGACTGTCTG -> TTAGGTGTAGACTGTCTGT
TTTAGTCCTGCAGCCTGTA -> TTAGTCCTGCAGCCTGTAA
TTTCACTTTTTACTATGTA -> TTCACTTTTTACTATGTAA
TTTCATTGGAGTCAAGCCA -> TTCATTGGAGTCAAGCCAC
TTTCCATAACCCAGTCTGC -> TTCCATAACCCAGTCTGCA
TTTCCCATGGCCGCCGGTG -> TTCCCATGGCCGCCGGTGC
TTTGAATGTATGACTCACA -> TTGAATGTATGACTCACAA
TTTGATACATGTTCGCAAC -> TTGATACATGTTCGCAACC
TTTGGACTGAATACTTTTG -> TTGGACTGAATACTTTTGT
TTTGGTACTCCTTGCGGAT -> TTGGTACTCCTTGCGGATC
TTTGGTGTAGTACGGACGC -> TTGGTGTAGTACGGACGCT
TTTGTCAGGTGGCAGGGCC -> TTGTCAGGTGGCAGGGCCA
TTTGTCGAGCGAAACCATT -> TTGTCGAGCGAAACCATTA
TTTGTTTTTGGTGTAGTAC -> TTGTTTTTGGTGTAGTACG
TTTTACTATGTAAGGGGAC -> TTTACTATGTAAGGGGACT
TTTTCACTTTTTACTATGT -> TTTCACTTTTTACTATGTA
TTTTCCCATGGCCGCCGGT -> TTTCCCATGGCCGCCGGTG
TTTTGATACATGTTCGCAA -> TTTGATACATGTTCGCAAC
TTTTGGTGTAGTACGGACG -> TTTGGTGTAGTACGGACGC
TTTTGTCGAGCGAAACCAT -> TTTGTCGAGCGAAACCATT
TTTTTACTATGTAAGGGGA -> TTTTACTATGTAAGGGGAC
TTTTTGGTGTAGTACGGAC -> TTTTGGTGTAGTACGGACG
